.Sarojini Naidu with Mahatma Gandhi	Mahatma Gandhinka saha Sarojini Naidu
1)Sanskrit is world's oldest language of vedas.	Sanskrit heuchi biswara sarb puratana bhasha
1.5 (numerical value)	dedo 
1.5 hrs	dedo ghanta
2 Sursaravali	2 sursaravali
2.5 hrs	adhai ghanta
2.5(numerical value)	adhai 
3 times 5 is 15.	3 thara 5 heuchi 15
4 people sat	chari jana basipadila
a	gotea
A  month has four weeks	gotie masare caroti saptaha thae
A boat capsized.	Eka danga budigala
A car hit Tom.	Eka car Tom ku dhakka deithila.
A car went by.	Eka car gala.
a child is sitting over there	saithi gote pila basichi
a few	alp kichi
A fish can swim.	Eka macha pahanripare
A list of plugins that are disabled by default	default bhabre akhyam hoithiba pluginagudikare eka talika
a little	tike 
A man must work.	Jane byakti kama kariba jaruri
A man must work.	Mu ethare ekaki achi ki?
"A tress has roots, branches, leaves, fruits and life too"	"Gachara cera thaye, dala thaye patra thaye. phala thaye o jiban thae"
A year has twelve months	Gotie barsa re barati masa thae
aback	aback
abacus	abacus
abandon	parityaga kariba
abandonment	tyaga
abase	apamanit kara
abatement	abaroda
abbreviate	sanchipta
abbreviation	sanchiptakarana
abdicate	tyaag karantu
abdomen	peta
abduct	apaharan
abeyance	palan
abhor	ghrinya
abide	ruha
ability	dakshta
ablaze	niyaan
able	saksham
ably	ably
abnormal	aswabhabik
aboard	boardre
abolish	radd
aborigines	aadibasi
aborigional	aadibasi
abort	garbhapat kara
abortion	garbhapat
abound	prachur
about	bisayare
about the world than the chimpanzees.	Chimpanzee apekhya duniya bishayare
above	upare
abreast	purba
abridge	abridge
abridgement	sanchiptakarana
abroad	bidesh
abrupt	akasmik
abscond	palatak
absence	anupasthiti
absent	anupasthit
absentee	anupasthit
absolute	sanpurna
absorb	shoshana
abstain	nibrutta hua
abstinence	nibruttata
abstract	bistruta
abstruse	abstruse
absurd	abishapasniya
abundance	prachurata
abundant	prachur
abuse	abyabahaara
abysmal	abakshaya
abyss	akshya
academic	academic
academician	academician
academy	academy
accede	jogdaan
accent	uccharana
accept	grahan kara
acceptance	grahan
Accerciser Accessibility Explorer	Accerciser Accessibility Explorer
access	prabesh
accessory	aanushangik
accident	durghatana
acclaim	prashansa
accomodation	rahani
accompany	saangare
accomplice	sahajyogi
accomplish	sampanna kara
accord	sammati
accost	accost
account	khata
accountancy	accountancy
accountant	accountant
accredit	suikruti
accumulate	jamaa kara
accuracy	sathikta
accurate	sathik
accusation	abhiyoga
accuse	abhiyoga
accustom	abhyas
ache	dard
achieve	haasil kara
achievement	safalata
acid	acid
acknowledge	swikaara kara
acknowledgement	swikruti
acoustic	shabda
acquaintance	parichaya
acquiant	parichit
acquire	prapta karantu
acquisition	adhigrahana
acquit	nirdosh
acqulesce	prapti
acre	acre
acrid	teekha
acrimony	tibrata
acrobat	acrobat
acropolis	acropolis
act	karjya
action	karjya
active	sakriya
activity	karjyakalapa
actor	abhineta
actress	abhinetri
adjourn	adjourn karantu
adjudge	bichaar karantu
adjunct	sanyojna
adjust	adjust karantu
adjustment	adjustment
administer	prashasaka
administration	prashasan
admiral	admiral
admiration	prasansha
admire	prasansha kara
admission	admission
admit	swikaar karantu
admonish	upadesh diya
adolescence	yubabastha
adopt	grahan
adoption	grahan
adoration	aadar
adore	aadar kara
adorn	shobha
adrift	adrift
adult	bayask
adulterate	byabhichaar
adultery	byabhichaar
advance	agrim
advantage	subidha
advent	aagman
adventure	sahasikarta
adversary	shatru
adverse	pratikula
adversity	pratikula paristhiti
advertise	bigyapana diya
advertisement	bigyapana
advice	paramarsha
advise	paramarsha diya
adviser	paramarshadata
advocate	wokil
aerate	aerate
aerial	baayu
aeronaut	aeronaut
aeroplane	bimaan
aesthete	aesthete
affable	snehi
affair	prem
affect	prbhaba
affection	sneh
affidavit	paramanapatra
affilliate	anubandita
affinity	sneha
affirm	nishchit kara
affix	affix
afflict	dukha
affluence	dhana
affluent	dhani
afford	sulabha
afforest	banabibhaga
afforestation	brikhyaropana
affront	aafront
afloat	afloat
afoot	afoot
afraid	bhaya
afresh	sateja
after	pare
afternoon	aprahna
afternoon	mdhyanha
again	punarbara
against	bipakshare
agape	kintu
age	bayasa
ageless	bayasaheen
agency	sanstha
agenda	karjyasuchi
agent	agent
aggravate	bruddhi
aggravation	bruddhi
aggregate	samudaaya
aggression	aakrosh
aghast	aghast
agile	kathin
agitate	andolon
agitation	aandolona
ago	purbaru
agree	raaji hua
agreement	chuktinama
agriculture	krushi
ahead	aagaku
aid	sahajyata
ail	asustha
ailment	asusthta
aim	lakhya
air	baayu
air force	baayu sena
air hostess	biman paricharika
aircraft	bimaan
airline	biman seba
airmail	airmail
akin	sadrushya
alarm	alarm
alas	haaye!
albeit	jadiau
album	album
alcohol	madyapaan
alert	satarka
algae	shaagagudika
alias	chhandanaama
alienate	bichinna
alimony	almirah
alive	jibanta
All aboard!        	Pura bahare
all efforts gone	bhasigala
allege	abhibhoga
allergy	allergy
alliance	militota
allowance	battha
almighty	sarbashaktimana
"Almost goes to E, but otherwise the play would be over."	Praya E ku jaye kintu anyatha nataka shesha hoyijiba
alone	akutiya
already	purbaru
alter	paribartana
alternate	bikalpa
altitude	uchhata
altogether	ekatra
aluminium	aluminium
Am I alone here?	Mu tumaku birakta karuchi ki?
Am I approved?	Mun aumodita ki ?
Am I boring you?	Mu tumaku birakta kruchi ki?
Am I boring you?	Mu tumaku birakta kruchi ki?
Am I boring you?	Mu tumaku birakta kruchi ki?
Am I dreaming?	Mun swapna dekhuchhi ki?
am i fat. 	Mu ki mota ?
am i fat. 	Mu ki mota ?
Am I mistaken?	Mun bhul karuchhi ki ?
Am i right?   	Mun kana thik khili
Am I safe now?	Mun bartamaan surakhita achhi ki ?
amaze	ashcharyachakita
ambassador	rashtraduta
amend	sanshodhana
amicable	bandhutwapurna
ammunition	goligola
amneity	subidha
among 	madhyare
amount	marimana
amuse	amoda
anaesthesia	anaesthesia
analysis	bishleshana
anatomy	anatomy
anchor	anchor
ancient	prachina
and come	aau aase
And I think any wise life will accept	Eban mu bhabuchi je kaunasi gyani jeebana grahan kariba
"and that is for their children to grow up successful,"	Eban taha heuchi semanankara pilamane safala heba payi
"And who are we to say, even, that they are wrong"	Ebam aame kahaku kahi na epariki semane bhul
"And you can see, this LED is going to glow."	Eban aapana dekhiparibe ehi LED chamkibaku jauchi
anectode	upaniyasha
angry	krodhita
animal	pashu
ankle	godha
anniversary	barsiki
announce	ghosana
annoy	birakta kar
annul	batil
another	alaga
answer	uttara
answer Tom       	Tom ku utara kara
antagonist	birodhi
anthem	sangeta
anticipate	asha kara
antidote	antidote
antique	prachina
anti-social	samajik birodhi
antonym	antonym
anxiety	chinta
anxious	chintita
any difficulties?	kichi asubidha ki
Any new jokes?	Jekonsi nua hasyapada ?
Any questions?	kaunasi prashna ?
Any questions?	kaunasi prashna ?
Anybody will do.	Jekehi karibe
anything	kichhi
Anything else?	Au kichhi ?
apart	aloga
ape	mankada
apoclyapse	sarbanasha
apology	khyama prarthona
apparent	spasta
appeal	abedana
appearance	rupa
append	jodantu
appetite	bhoka
applause	karatali
apply	prayoga karantu
appointment	niyukti
approach	upaya
appropriate	upayukta
approval	anumodana
approximation	anumanikata
apricot	apricot
apron	kapda
apt	uchita
aptitude	dakhyata
aquarium	maccha ghara
arbitrary	ekchadina
arc	arka
arcade	arcade
arch	arch 
archaeology	puratatwa
archery	tirandaza
architect	sthapti
archives	abhilehagara
ardent	prachanda
Are drinks free?	Paneya gudika magana ki?
Are ghosts real?	Bhuta mane prakruta ki?
Are my ears red?	Mora kana lal ki?
Are my ears red?	Mora kana lal ki?
Are these yours?	Egudika tumara ki?
Are they busy?	Semane byasta achhanti ki ?
Are they tall?	Semane lamba ki ?
Are we done yet?	Ame eprajanta karisarichu ki?
Are we prepared?	Ame prasustha ki?
Are we safe now?	Ame bartaman surakhita ki?
Are you a fan?	Apana jane prasansaka ki?
Are you a fan?	Apana jane prasansaka ki?
Are you a ghost?	Tume bhuta ki?
Are you alone?	Apana ekaki ki ?
Are you anxious?	Apana chintita ki?
Are you at home?	Tume ghare acha ki?
Are you awake?	Apana jagrat ki ?
Are you awake?	Apana jagrat ki ?
Are you blind?	Tume andha ki ?
Are you bored?	Tume andha ki ?
Are you brave?	Tume sahashi ki ?
Are you certain?	Apan nischita ki?
Are you content?	Apana santusta ki?
Are you crazy?	Tume pagala ki ?
Are you curious?	Apana agrahi ki?
Are you drunk?	Tume madyapa ki ?
Are you drunk?	Tume madyapa ki ?
Are you envious?	Tume ersha karucha ki?
Are you envious?	Tume ersha karucha ki?
Are you envious?	Tume ersha karucha ki?
Are you excited?	Apana uschahita ki?
Are you excited?	Apana uschahita ki?
Are you excited?	Apana uschahita ki?
Are you happy?	Tume khusi achha ki ?
Are you happy?	Tume khusi achha ki ?
Are you happy?	Tume khusi achha ki ?
Are you healthy?	Apana sustha ki?
Are you kidding?	Tume thata karucha ?
Are you kidding?	Tume thata karucha ?
Are you looking?	Apna dekhuchanti ki?
Are you married?	Tume bibahita ki?
Are you married?	Tume bibahita ki?
"Are you OK, Tom?"	"Tume thik achi,Tam?"
Are you Ok?      	Tame kn thik acha 
Are you over 18?	Apana 18 ru adhika ki?
Are you ready?	Tume prasthuta achha ki ?
Are you ready?	Tume prasthuta achha ki ?
Are you serious?	Tume gambhera ki?
Are you serious?	Tume gambhera ki?
Are you serious?	Tume gambhira ki?
Are you serious?	Tume gambhira ki?
Are you short?	Tume chhota ki ?
Are you there?	Apana sethare achhanti ki ?
Are you tired?	Tume haalia achha ki ?
Are you tired?	Tume haalia achha ki ?
Are you tired?	Tume haalia achha ki ?
Are you unhappy?	Tume asantusta ki?
Are you working?	Tume kama karicha ki?
Are you working?	Tume kama karucha ki?
area	kshetra
Aren't you busy?	Apana byasta nuhanti ki?
Aren't you busy?	Apana byasta nuhanti ki?
Aren't you busy?	Apana bysta nuhanti ki?
Aren't you cold?	Tume thanda nuha ki?
Aren't you late?	Tume bilamba karu naha ki?
argue	bahasa
argument	jukti
arid	shushka
arise	utha
aristocrat	abhimukhyabadi
arm	hatha  
armchair	hatha kursi
armour	kawach
army	sena
aroma	sugandha
aromatic	sugandhita
around	charipakhare
arrangement	vyabashtha
arrest	girafa
arrogant	aahankari
arrow	teera
art	kala
article	prabandha
artifact	kalakriti
artificial	krutrima
artist	kalakara
arts	kala
Aryans did not make any statues or temples for deities.	Arya mane debatamaananka payi murti kimba mandira tiyaari kari nahanti
ascend	arohana
ashamed	lajjita
Ask an expert.	Jane bisesagyan nku pachara.
Ask an expert.	Jane bisesagyan nku pachara.
ask john	john ku pachara
Ask me anything!	Mote kuchi pachara!
Ask me tomorrow.	Asantakali mote pachara
ask them. 	Tanku pachara
ask them. 	Tanku pachara
ask tom	tom ku pachara
Ask Tom again.	Tom ku puni pachara.
aspect	diga
aspire	aakhankhya
assassination	hatya
assault	aakramana
assert	nishchita kara
assertion	dharana
assessment	mulyankana
assign	nyasta karantu
assist	shahajya karantu
associate	sahajogi
association	sangathana
assume	anumaan kara
assumption	anumana
assurance	nishchitata
astonishment	aascharya
astringnet	kasha
astrology	jyotisha shashtra
astronaut	mahaakshachari
astrophysics	jyotirbigyana
athelete	khiladi
atmosphere	paribesha
atom	parmaanu
attach	snlagna karantu
attack	akraamana
attempt	chesta
attend	dhyana heba
attentive	dhyana
attire	poshaka
attorney	vawkila
attraction	aakarshana
auction	nilama
audacity	adamyata
audience	dharshka
auditor	ausitora
aunt	khudi
auspicious	subha
authentic	pramanika
authority	pradhikarana
autography	aamrajibana
automatic	swaiyamchalita
automobile	gadhi
avail	labha kara
average	harahari
avert	pratirodha
avid	agrahi
avoid	aedhantu
await	apaikhya kara
award	puraskaara
aware	sachetana
awful	bhayankara
awkward	ashuba
axe	kuraa
axiom	axiom
axle	akhya
baby	shishu
bachelor	abibahita
back	pachoku
back off.	 Dureyi hei jao
back off. 	Dureyi hei jao
back(body part)	peethi
backbencher	backnbencher
backdoor	pacha kabata
backfire	safal na hela
background	prusthabhumi
backlog	backlog
backstage	prusthapata
backward	pachoku
bacteria	jiwanu
bad	kharap   
bad tempered	kharap swabhava
badge	byaja
baffle	badha
bag	bosta
bail	jamina
bait	topi
bake	randha
bakery	bakery
balance	santulana
balcony	balcony
ball	genda
ballad	baladh
ballet	ballet
balloon	phugga
ballot	matadana
ballpoint	ballpoint
Balls are round.	Ball golakara
balm	marhama
bamboo	baunsa
ban	nishedha
banana	kadali
band	baand
bandage	bandage
bandit	brundabana
bang	thokiba
banish	tadhi diya
bank	bank 
bankrupt	debaliya
banquet	bhoji
baptism	baptisma
bar	dandika
barbecue	barbecue
barber	barbaati
barber	bhandari
bargain	sauda
barge	byyarage
bark	bhukiba
barrier	pratibandhaka
base	aadhara
basic	malika
basis	aadhara
basket	tokei
basketball	basketball
bat	bat
batch	batch
bath	snaana
battery	battery
battle	yudha
Be a good boy.	Bhala pua hua.
be brave. 	Bhadur huya
be brave. 	Bhadur huya
be careful.    	   Sajag ruha 
be cool	thanda hua
be kind. 	Daya kara
be kind. 	Daya kara
be nice. 	Bhala hua
be nice. 	Bhala hua
Be reasonable.	Juktijukta hua.
be serious        	Gabhiratara sahita
beach	belabhumi
beak	beak
beam	beam
bear	bhalu
beard	daadhi
beast	pashu
beat	maare 
beat it. 	Mara taku
beat it. 	Mara taku
Beat the eggs.	Andaku pitantu.
Beat the eggs.	Andaku pitantu.
beautiful	subndara
because	karana
Because of these the Supreme Court has made some restrictions on its own	Ehi karanaru supremecourt nije kichi pratibandhak lagayi chanti
become	hua
bed	shanjya
bedsheets?	chadara
bee	madhumakshi
beer	mada
Bees make honey.	Mahumachi mahu tiari kare
before	purbaru
before	purbaru
befriend	bandhu
beg	bhika manga
beggar	bhikhari
begin	aarambh kara
behalf	tarapharu
Behave yourself.	Nijaku byabahara kara
Behave yourself.	Nijaku byabahara kara
Behave yourself.	Nijaku byabahara kara
behaviour	vyabahara
behind	pachare
belief	bishwas
believe	bishwas kara
belong	sampatti
below	nimnare
belt	belt
bench	bench
bend	banka
beneficial	labhadayaka
benefit	labha
benign	uttama
berry	biri
besides	eha byatita
best	sarbottama
best	sarrvouttama
bestow	pradana karantu
bet	baji
between	madhyare
beverage	paniya
beware	sabadhana ruha
beyond	bahare
bias	pakhyapata
bidder	boli lagaeba loka
big 	bada
bigot	kattara
bill	bill
bind	bandha
binoculars	daduyipakshyika
biography	jibani
biology	jeev vigyana
biotechnology	biotechnology
bird	pakshi
birds sing        	Pakhimane gita gaanti
birth	janama
birthday	janmadina
bison	bison
bitch	kukura
bitter	pita
bitter	tikta
bizzare	khuba kharap
black	kala
black	kala
black	kala
Black suits you.	Kala tumaku suit kare
Black suits you.	Kala tumaku suit kare
Black suits you.	Kala tumaku suit kare
Black suits you.	Kala tumaku suit kare
blackmail	blackmail
blacksmith	kamara
blacksmith	krushnakaya
blade	blade
blame	dosha
blank	khali
blanket	kambala
blast	bisphorana
blaze	niyan
bleach	bleach
bleed	raktasraaba
blend	mishrana
bless	aashirwada karantu
blind	aandha
blink	laka
bliss	sukha
bloat	fulijiba
block	lugapata
bloom	phoola
blot	dhabba
blow	fukiba
blue	neelao
blue	nila
blue	nila 
bluff	jhoota
blunder 	truti
blur	aaspasta
blush	lajja
boar	suwara
boarding	chtraniwasa
boast	garbha kara
boat	daanga
boatman	nauria
body	sharira
bodyguard	aangrakhaka
bogus	farjii
bold	dhadaka
bolt	chatkani
Bon appetit	subha trupti
bood	luha
book	bahii
Boys are stupid.	Puamane murkha
Boys are stupid.	Puamane murkha
brahmin	brahmana
brazier	kansari
Bring him to me.	Tanku mo pakhaku ana
Bring it here.	Ehaku ethaku ana.
Bring it here.	Ehaku ethaku ana.
Bring it here.	Ehaku ethaku ana.
Bring that here.	Ehaku ethaku ana
Bring the key.	Chabi ana.
bring wine.       	mada anaa
brown	badami
Buddha and danceroom (1958)	Buddha eban nrutyashilpa 1958
"But if you agree to allow the seller extra time , you cannot cancel until that time is up ."	Kintu jadi aapana bikretanka atirikt samaya debaku anumati diyanti tebe sehi samaya shesha na heba parjyant aapana baatil kariparibe nahi
But January 2002 has been quiet .	Kintu January 2002 chup rahila
butcher	kansei
Call me later.	Pare mote daaka.
call me. 	Mote call kara
call me. 	Mote call kara
Call security!	Surakya call karantu.
Call security!	Surakya call karantu.
Call the police!	Police ku taka!
Call the police!	Police ku taka!
call tom. 	Tom ku daka
call tom. 	Tom ku daka
came	asila
Can he see us?	Se amaku dekhiparibe ki ?
Can I ask why?	Mun pacharibi kahinki ?
Can I ask why?	Mun pacharibi kahinki ?
Can I bring Tom?	Mu tam ani paribi ki?
Can I come over?	Mu asi paribi ki?
Can i help?      	 Mun kn saharjya kriparibi
Can I join in?	Mun ethire joga deiparibi ki ?
Can i sing?       	Mun kn gita gaiparibi
Can i stay?        	Mun kn ethare rahiparibi
Can I use your phone ?	Mun tuma phone byabahara karipare ki ?
can I use your phone?	mun tuma phone byabhara karipare ki?
Can you describe me?	Tame Mate barnana karipariba?
Can you do it?	Apana eha kariparibe ki ?
Can you help me with this assignment?	Mate tike assignment karibare help karibu?
Can you imagine saying that?	Aapana eha kalpana kari paribe ki
Can you stand?	Tume thia hoipariba ki ?
Can you stand?	Tume thia hoipariba ki ?
Can you stand?	Tume thia hoipariba ki ?
can you suggest another hotel	anya kichhi panthasala achhi ki?
carpenter	badhei
cartman	shagadia
Category : Religion Author	Barg dharma lekhak
Category: Religious Text	Shreni dharmik patha
category:information technology	Barga suchana parjyuktividya
"Check, please."	Dayakari jancha karantu.
"Check, please."	Dayakari jancha karantu.
cheers	khusi
Cheers! Good health	khusi re ruhantu
Chicken 	Kukuda
"Children'sgo to school with pen, notebooks and books to read"	"Pilamane khata bahi, kalam nei pathapdhiba pal bidyalaya yai thanti"
Cinematography	Chitragrahana
class	shreni
Class : United States of America	Shreni Sanjyukt rashtra America
Clean that up.	Ehaku safa kara.
Clean that up.	Ehaku safa kara.
Clean that up.	Ehaku safa kara.
Close your eyes.	Aakhi band karo.
closed	baand haigala
closed	bond
cobbler	chamara
cold medicine	thanda aausodha
come	aasa
come	aasija
Come	Aasontu
come again         	authare asaa
come alone        	 ekutia asiba
come along.       	 asijao
Come back in.	bhitaraku aasa
come early.        	agaru asiba
Come forward.	aagaku aasa
Come forward.	aagaku aasa
Come forward.	aagaku aasa
Come forward.	aagaku aasa
Come forward.	aagaku aasa
Come forward.	aagaku aasa
Come help me.	mote sahajya kara
Come help me.	mote sahajya kara
Come help me.	mote sahajya kara
come in.	 Bhitara ku aasa
"Come on, Tom."	"aasa,Tom"
Come outside.	baharaku aasa
Come quickly!	shighra aasa
Come quickly!	shighra aasa
Come quickly.	shighra aasa
Come quickly.	shighra aasa
Come quickly.	shighra aasa
Come sit down.	"Asa, basa."
Come tomorrow.	Asantakali asa.
Come tomorrow.	Asantakali asa.
Come tomorrow.	Asantakali asa.
Come with me.	mo saange aasa
Come with me.	mo saange aasa
Come with me.	mo saange aasa
Come with me.	mo saange aasa
Come with us.	aama sahita aasa
Computer Science and Engneering	Sanganak Bigyan O abhijantriki
confectioner	gudia
Cook the rice.	Chaula raandha.
"couldn∆t do anything ,even if i wanted "	chahiki bhi kichi kariparilini
Count to ten.	das parjyanta ganana kara
cowherd	gai jaguala
Cut that out!	ehaku kaati diya
Cut that out!	ehaku kaati diya
Dad's working.	Bapanka kama.
Dad's working.	Bapanka kama.
dance(verb)	nachunu
day	dina
Day	Dino
day before yesterday	pahardino
Deal with it.	eha sahita karobaar karantu
Deal with it.	eha sahita karobaar karantu
Describe Tom.	Tom ra barnana kara
device	yantraa
did	karidaithila
Did I do that?	Mun taha kali ki ?
Did Tom come?	Tom aasichanti ki?
Did Tom drown?	Tom budigala ki ?
Did Tom faint?	Tom durbala hoigala ki ?
Did Tom faint?	Tom durbala hoigala ki ?
Did Tom fall?	Tom khasigala ki?
did Tom go?       	Kn Tom gala
Did Tom help?	Tom sahajya kala ki?
Did Tom know?	Tom jaanithile ki?
Did Tom laugh?	Tom hasila ki ?
Did Tom leave?	Tom chaligale ki ?
Did Tom leave?	Tom chaligale ki ?
Did Tom mind?	Tomankara mana thila ki?
Did Tom pray?	Tom prarthana kala ki
Did Tom reply?	Tom uttara deichhanti ki ?
Did Tom sing?	Tom gayithile ki?
Did Tom stay?	Tom rahile ki?
Did Tom swim?	Tom paharila ki?
Did Tom vote?	Tom vote deichanti ki?
did u eat?	tame khaicha?
Did you call?	Tume call kruthila ki?
Did you do it?	Apana eha karichhnati ki ?
Did you do it?	Apana eha karichhnati ki ?
Did you do the assignment? 	Tame assignment karideicha ki? 
Did you have your lunch ?	Khayilo ki ?
Did you sign?	aapana dastakhat karichanti ki?
Did you vote?	aapana vote deichanti ki?
Did you vote?	aapana vote deichanti ki?
didn∆t he/she give anything to eat	khaibaku kichi daini
die	marijaa
died today	aaji marigale
Dig a deep hole.	Eka gabhira gaata khola.
Dinner is ready.	Ratri bhojana prastuta.
distiller	shundi
do	karide
Do as he says.	Se jepari kuhanti taha kara.
Do cats dream?	Bileimane swapna dekhanti ki ?
do charge it	charge karidia
Do I have to go?	Mote jibaku padiba ki?
Do I know him?	Mun taku jane ki ?
Do I look fat?	Mun mota dekhajauchhi ki ?
Do I need a tie?	Mora eka tie darkar ki?
Do it anyway.	jaha bhi heu taha kara
Do it anyway.	jaha bhi heu taha kara
Do it at once.	Ehaku thare kara.
Do it for me.	eha mo payi kara
Do it for me.	eha mo payi kara
Do it quickly.	Ehaku sighra kara.
Do it right now.	Aehaku bartamana kara
Do it with me.	Mon sahita eha kara.
do like that	saita ka kare
Do me a favor.	Mote eka anugraha kar.
Do not tempt me.	Mote parikhya kara nahi
Do we have time?	Aamara samaya achi ki?
Do what I say.	Mun jaha kahuchhi taha kara.
Do what I say.	Mun jaha kahuchhi taha kara.
Do what I say.	Mun jaha kahuchhi taha kara.
do whatever you want	kana karuchu kare
Do you agree?	aapana ekmat ki?
Do you disagree?	Aapana†aethire†sahamata†nuhanti†ki?†
Do you disagree?	Aapana†aethire†sahamata†nuhanti†ki?†
Do you eat meat?	Aapana†manksa†khauchanti†ki?
Do you eat meat?	Aapana†manksa†khauchanti†ki?
Do you eat meat?	Aapana†manksa†khauchanti†ki?
Do you enjoy it?	apana†aehaku†upabhoga†karanti†ki?
Do you follow?	Apana anusarana karanti ki ?
Do you follow?	Apana anusarana karanti ki ?
Do you follow?	Apana anusarana karanti ki ?
Do you have a safe ?	Nirapada baksa achchi ki ?
Do you have any pet?	Kn tuma pakhre gote posa jeeba achi?
Do you have any rooms available ?	Kichhi kakhya phanka achhi ki ?
Do you have any rooms available?	kichhi kakhya phanka achhi ki?
Do you have one?	†Tumara†gotiye†achi†ki?
Do you have one?	†Tumara†gotiye†achi†ki?
do you have this in my size?	apananka pakhe mo size ra eehi jinisa ti aachi ki?
Do you know her?	Tume†tanku†janicha†ki?
Do you know her?	Tume†tanku†janicha†ki?
Do you know her?	Tume†tanku†janicha†ki?
Do you know him?	Aapana†tanku†jananti†ki?
Do you know why?	Aapana†jananti†kahinki?
Do you like rap?	Aapana†rap†pasand†karanti†ki?
Do you remember?	Tumara†mane†achi†ki?†
Do you see me?	Mote dekhiparuchha ?
Do you see me?	Mote dekhiparuchha ?
Do you see me?	Mote dekhiparuchha ?
Do you see that?	Aapana†taha†dekhuchanti†ki?
Do you see that?	Aapana†taha†dekhuchanti†ki?
Do you smoke?	aapana dhumrapaan karanti ki?
Do you smoke?	aapana dhumrapaan karanti ki?
Do you smoke?	aapana dhumrapaan karanti ki?
do you speak english?	apana inraji kuhanti ki?
Do you speak english?	tume english kahipara?
do you speak odia?	apana oria kuhanti ki?
Do you think so?	Aapana†aepari†bhabuchanti†ki?
Do you think so?	Aapana†aepari†bhabuchanti†ki?
Do you think so?	Aapana†aepari†bhabuchanti†ki?
Do you trust me?	Aapana†mote†biswasa†karanti†ki?
Do you trust me?	Aapana†mote†biswasa†karanti†ki?
Do you want any?	Aapana†kichi†chahunchanti†ki?
Do you want any?	Aapana†kichi†chahunchanti†ki?
Do you want any?	Aapana†kichi†chahunchanti†ki?
Do you want him?	Aapana†tanku†chahunchanti†ki?
Do you want him?	Aapana†tanku†chahunchanti†ki?
Do you watch TV?	Aapana†TV†dekhanti†ki?
Do your best!	tumara shrestha diya
Do your best!	tumara shrestha diya
Do your best!	tumara shrestha diya
Do your best.	tumara shrestha diya
Do your best.	tumara shrestha diya
Does he know me?	Se mote†jananti†ki?
Does he like me?	Se mote†pasanda†karanti†ki?
Does it hurt?	eha kashtadayak ki
Does it show?	eha dekhye ki?
Does it work?	eha kaam kare ki?
Does it work?	eha kaam kare ki?
Does it work?	eha kaam kare ki?
Does that count?	Taha†gananaa†kare†ki?
Does the room come with bedsheets ?	Kakhya sahita chadara miliba ki ?
Does this count?	Taha†gananaa†kare†ki?
Dog	Kukura
Dogs can swim.	Kukuramane pahanriparanti.
don∆t say anything else	aau kichi kahana
don∆t you have shame	lajjoo laguni
done	haigala
Don't apologize.	Khyama†maagantu†nahi.†
Don't ask me.	mote pachara nahi
Don't be a fool.	Murkha†hua†nahi.
Don't be a snob.	†Snob†hua†nahi.
Don't be afraid.	Bhaya†kara†nahi.
Don't be afraid.	Bhaya†kara†nahi.
Don't be late.	Bilamba kara nahi.
Don't be late.	Bilamba kara nahi.
Don't be long.	Lamba huantu nahi.
Don't be rude.	Abhadra byabahara kara nahi.
Don't be rude.	Abhadra byabahara kara nahi.
Don't be rude.	Abhadra byabahara kara nahi.
Don't be sad	Dukhi huantu nahi
Don't be sad.	dukha kara nahi
Don't be sad.	dukha kara nahi
Don't be scared.	Bhaya†kara†nahi.
Don't be shy.	laja kara nahi
Don't be so shy.	Ete†lazzita†hua†nahi.
Don't be so shy.	Ete†lazzita†hua†nahi.
Don't be stingy.	Kalankita†huantu†nahi.
Don't be stupid.	Murkha†hua†nahi.†
Don't bother me.	Mote†hairaana†kara†nahi.
Don't bother me.	Mote†hairaana†kara†nahi.
Don't bug me.	mote bug karantu nahi
Don't bug me.	mote bug karantu nahi
Don't cheat him.	Tanku†prataaranaa†kara†nahi.
Don't come in.	Bhitaraku asantu nahi.
don't come.        	 Asibani
Don't follow me.	Mote†anusarana†kara†nahi.†
Don't follow me.	Mote†anusarana†kara†nahi.†
Don't follow me.	Mote†anusarana†kara†nahi.†
Don't forget it.	Aehaku†bhulantu†nahi.
Don't forget me	mote bhulibe nahi
Don't forget.	bhulantu nahi
Don't forget.	bhulantu nahi
Don't freak out.	†Freak out†karantu†nahi.
Don't freak out.	†Freak out†karantu†nahi.
Don't get angry.	Raagantu†nahi.
Don't get drunk.	Madyapaana†kara†nahi.
Don't get fat.	Mota huantu nahi.
Don't get fat.	Mota huantu nahi.
Don't give in.	Diantu nahi.
Don't go yet.	eparjyanta jaantu nahi
Don't go yet.	eparjyanta jaantu nahi
Don't go yet.	eparjyanta jaantu nahi
don't go. 	Jaa ni
don't go. 	Jaa ni
Don't harm them.	Semananku†khyati†kara†nahi.
Don't insult me.	Mote†apamaana†kara†nahi.
Don't insult me.	Mote†apamaana†kara†nahi.
Don't interfere.	Aethire†hasthakhepa†karantu†nahi.
Don't let go.	chadantu nahi
Don't lie to me.	Mote†micha†kuha†nahi.
Don't lie to me.	Mote†micha†kuha†nahi.
Don't lie to me.	Mote†micha†kuha†nahi.
Don't lie to me.	Mote†micha†kuha†nahi.
don't look          	dekhanahi
Don't look back.	Pachaku†dekha†nahi.
Don't look down.	Talaku†dekha†nahi.
don't move.         	agaku badhanhi
Don't play dead.	Mruta†khelantu†nahi.
Don't remind me.	Mote†manerakha†nahi.
Don't remind me.	Mote†manerakha†nahi.
Don't resist us.	Amaku†pratirodha†kara†nahi.
Don't rub it in.	Aehaku†ghasantu†nahi.†
Don't run risks.	Bipada†gudika†chalantu†nahi.
Don't stop here.	Aethare†ataki†jao†nahi.
don't talk.          	katha kuha nhi
Don't tell lies	Micha kuhani
Don't tell lies.	Micha†kuha†nahi
Don't touch me	mate chuan nahin
Don't trust him.	Tanku†biswasa†kara†nahi.
Don't trust him.	Tanku†biswasa†kara†nahi.
Don't trust Tom.	Tom†upare†biswasa†kara†nahi.
don't wait           	apakshy kra nhi
don't wait           	apakshy kra nhi
"Don't worry, everything will get better with time"	"Chinta kara ni, samay sahita sabu kichi thik heijiba"
Don't you agree?	Apana†raazi†nuhanti†ki?
Don't you agree?	Apana†raazi†nuhanti†ki?
door was shut 	kali door band nathila
drink	peeba
Drink something.	Kichi†piyantu
Drink something.	Kichi†piyantu
Drive faster.	shighra drive karantu
Drive faster.	shighra drive karantu
Drive safely.	surakhshit bhabare chalantu
Drive safely.	surakhshit bhabare chalantu
Drive slowly.	dhire dhire chalantu
Drop the gun.	banduk chadi diya
Drop the gun.	banduk chadi diya
during that time	se majhire
east	purba
Easy does it.	sahaj eha kare
Easy does it.	sahaj eha kare
eat	khaiba
eat slowly           	dhire khadya khao
eat something	khaide
Energy	Sakte
engineering	abhijayantriki
entrance	prabesha
Evening	Sndhya
Every five years	Prati 5 barsa re
everything is in one place 	sabu gote aire achi na
Examine this.	ehaku parikhya karantu
Excuse me	aangya
Excuse me	khyama karibe
exit	prasthana
External links	Bahya link
face	muhaa
face is not visible	muha dusuni ka
Fast	Sighra
Father	Bapa
fell down	padigali 
ferryman	ghatia
fill it up            	ehaku purana kra
find a job           	chakiri khoja
find tom.	 Tom ku khojo
find tom. 	Tom ku khojo
fire burns.          	agni jale
Fire!	agni!
"Fish, please."	"macha, dayakari"
fisherman	keuta
follow him          	taku anusarana kraa
follow Tom         	 Tom ku anusarnaa kra
"For instance , soft-drink giant Coca-Cola Inc is seeking exemption from a public issue ."	Udahrana swaroop mridu paniya bishal Coca Cola eka sadharana prasanga ru mukta hebaku chahuchi
"For Jayendra Saraswati , the spiritual has never been static ."	Jayendra Saraswatinka payi adhyatmik kadapi sthir heyinahi
For what	Kana pain
Forget him          	Taku bhulijao
forgive us.          	ambhaku khyama kaara
freeze	freeze
freeze	freeze
fresh	tatka
Friday	sukrabar
front	agare
gardener	mali
get down. 	Tala ku aasa
get lost. 	Dureyi haba
get out. 	Bahara ku jao
get out. 	Bahara ku jao
Get the book.	bahi paa
get up	uthe
get well soon	sighra thik heijantu
Ghosts exist.	bhoot bidyamaan
give	daide
give her the gold one na	taku se sunna ra daidiya na
Give it back.	ehaku pherayi diya
Give it back.	ehaku pherayi diya
give it up           	parityaga kra
Give your application an accessibility workout	apanankara anuprayogkun eka accessibility workout  diyantu
go	jeeba
go ahead. 	Aaga ku jao
go away. 	Palei jao eithu
go away. 	Palei jao eithu
go bath 	ja gadhaide
Go to school.	bidyalaya ku jaa
go to work.         	kama ku jao
God exists.	 bhawano vidyamano achonti
goldsmith	bania
Good	Acchi
Good	bhala
good	vallo
good afternoon	subha khara bela
good bye	subidaya
good evening	subha sandhya
Good evening.	shubha sandhya
Good for you.	tuma payi bhala
Good for you.	tuma payi bhala
Good for you.	tuma payi bhala
good luck	sabu subha hau
Good Morning	Subha Sokalo
Good morning	suprabhata
good night	subhratra
Good night.	subhratri
goodbye 	Bidaya
goodbye 	Bidaya
Goodmorning 	Suprabhaata
got	milila
got it	bujhila
got it	bujhila
grab him. 	Taku dhara
greatly understate its impact.	Ehara prabhabku bahut kam karithaye
green	sabuja
green	sabuja
grey	dhusara
Hand it over.	ehaku hastantara karantu
hang on. 	Ruka tike
hang on. 	Ruka tike
Happy Easter!	easter abhinandan
Happy Easter!	easter abhinandan
Happy Ratha yatra!	Ratha jatra upalakse bahut abhinandana!
hard	kashta
harehunter	shabar
have a nice day	subha din
Have a nice day.	Apanankara dina mangalamaya heu.
Have another.	anya eka karantu
Have another.	anya eka karantu
Have another.	anya eka karantu
Have another.	anya eka karantu
Have another.	anya eka karantu
Have another.	anya eka karantu
Have courage.	sahasa kara
"have different colors and different textures to our eye,"	Aama akhire bibhinna ranga eban bhinna bhinna gathana
have fun. 	Maja kariba
Have you eaten?	Tame khailani ?
he	say
he ate an apple	say seo khaila
He avoids me.	se mote edanti
He avoids me.	se mote edanti
he called me 30 minutes ago	se mate teeris minute agaru dakithila
he came.	 Siye aasila
he came. 	Siye aasila
He coughed.	se kaaso kola
He could die.	se mariparanti
He denied it.	se ehaku aswikaara karichanti
He dozed off.	se band karidele
He dumped me.	se mote phophadidele
He dumped me.	se mote phophadidele
He dumped me.	se mote phophadidele
he eats an apple	say seo khaye
He gave in.	se dele
He gave it to me.	se taha mote dela
He gave it to me.	se taha mote dela
He gave me a hug.	se mote aalingana kale
He gave me a hug.	se mote aalingana kale
He gave up.	se haaro manile
He gets up early.	se sighra uthanti
he goes	say jaye
He got a D.	se eko d paile
He got a D.	se eko d paile
He got angry.	se ragigale
He had a dog.	taankara gotiye kukura thila
he had come	say aasithila
he had eaten	say khai thilla
He had few teeth.	tankara kichi danta thila
he had gone	say jaithilla
He has a bicycle.	tankara eka cycle aachi
He has a car.	taankara eka car achi
He has a dog.	taankara gotiye kukura achi
He has a Picasso.	tankara eka picasso aachi
he has eaten	say khaichi
He has long hair.	tankara lamba kesa aachi
He has lost face.	se muha haraichanti
He has money.	taank pakhare tanka achi
He hates carrots.	se gajara ku ghruna karanti
He hates himself.	se nijaku ghruna karanti
He hates spiders.	se spider ku ghruna karanti
He hates spiders.	se spider ku ghruna karanti
He hates spiders.	se spider ku ghruna karanti
He heard a shout.	se eka chitkar sunithile
He hung up.	se hung karela
He hung up.	se hung karele
He is a DJ.	se jone dj
He is a DJ.	se jone dj
He is a good boy.	Se gote bhala pila.
He is a kind boy.	se jane dayalu balika
He is a poet.	se jane kabi
He is a tall boy.	se ek lamba balaka
He is a tall boy.	se eka lamba balaka
He is aggressive.	se akramanatmaka
He is an Italian.	se jane jataliya
He is asleep.	se soichanti
He is chubby.	se chubby
He is cranky.	se pagala
He is cranky.	se pagala
He is doing well.	se bhala kaama karuchanti
He is driven.	se chalit
He is driven.	se chalit
he is eating an apple	say seo khauchi
He is eating.	se khauchanti
He is eating.	se khauchanti
He is French.	se Farasi
He is her friend.	se tankara bandhu
He is here!	se aaethare aachonti
He is heroic.	se beer atanti
He is his friend.	se tankara bandhu
He is in college.	se college re padhuchanti
He is in trouble.	se asubidha re aachanti
He is in trouble.	se asubidha re aachanti
He is kind.	se doyalu aachonti
He is kind.	se doyalu aachonti
He is mean.	se nisthoro
He is mean.	se nisthoro
He is my brother.	se mora bhai
He is my brother.	se mora bhai
He is my teacher.	se mora guru
He is never lazy.	se kadapi alasua nuhanti
He is nice to me.	se mo pai bhala
He is not stupid.	se murkha nuhanti
He is overweight.	se addhika ojania
He is past forty.	se chalis barsa bayasa re
He is photogenic.	se photographic
He is poor.	se goreebo
He is sick.	se aasuasth aachonti
He is still here.	se aeparjanta aethare aachanti
He is tall.	se lomba
He is unsociable.	se abismaraniya
He is up to date.	se adyatana atanti
He is very brave.	se bahut sahasi
He is very brave.	se bahut sahasi
He is very young.	se bahut chota
He isn't married.	se bibahita nuhanti
He isn't perfect.	se siddha nuhanti
He isn't perfect.	se siddha nuhanti
He just got home.	se kebala ghara pahanchile
He just left.	se chaligale
He just left.	se chaligale
He kept his word.	se tanka bakya palana kale
He knows my wife.	se mo stri ku jananti
He laughed.	se hoseele
He left after me.	se mo paache paache chaligale
He left his wife.	se tanka patni nku chadi chaligale
He left the room.	se kothari chaadi chaligale
He left the room.	se kothari chaadi chaligale
He left the room.	se kothari chaadi chaligale
He let us go.	se aamaku jibaku dele
He lied about it.	se eha bisaya re miicha kahithile
He likes animals.	se paasu manku pasand karanti
He likes fishing.	se maacha dharibaku pasand karanti
He likes hunting.	se sikara ku pasand karanti
He likes oranges.	se kamala pasand karanti
He likes singing.	se gita gaibaku bhala paanti
He likes to cook.	se roosei karibaku pasand karanti
He likes to hunt.	se sikara karibaku pasand karanti
He likes to swim.	se paharibaku pasand karanti
He looks healthy.	se sustha dekha jaanti
He looks his age.	se tanka bayasa ku dekhanti
He lost face.	se muha haraile
He lost his job.	se chakiri haraile
He loves animals.	se paasu manku bhala paanti
He loves coffee.	se coffee bhala paanti
He loves fishing.	se maacha dharibaku bhala paanti
He loves fishing.	se maacha dharibaku bhala paanti
He loves her.	se taanku bhala paanti
He loves singing.	se gita gaibaku bhala paanti
He loves singing.	se gita gaibaku bhala paanti
He loves singing.	se gita gaibaku bhala paanti
He loves soccer.	se football ku bhala paanti
He loves to fish.	se maacha maribaku bhala paanti
He loves to fish.	se maacha maribaku bhala paanti
He loves trains.	se train ku bhala paanti
He made for home.	se ghara paain tiaari kaale
He made her cry.	se taku kandila
He made it.	 se aaehaku tiyari kole
He made me do it.	se mote taha karbaku prastuta kale
He made me sing.	se mate gita gaaile
He mentioned it.	se eha ullekha karichanti
He moves quickly.	se sighra gaati kaare
He must be dead.	se nishchaya mruta
He must be tired.	se nischaya thaki jaaithibe
He must love you.	se nischaya tamaku bhala paaiba
He must not live.	se baanchiba  uchit nuhe
He never laughs.	se kadapi hasanti nahi
He nodded to me.	se mate aanthei dele
He often spoke to us of his own great longing to meet him	Taanku bhetiba paayi se onek samyare nijara bahut ichcha bisayare aama sahit katha heuthile
He painted a dog.	se gote kukura ku ranga karithila
He played tennis.	se tennis kheli thila
He put up a flag.	se eka pataka lagaila
He quit smoking.	se dhumrapaan tyaga karithile
He quit smoking.	se dhumrapaan tyaga karithile
he ran	se dadigala
he ran 	se daudigala
He ratted us out.	se amaku bahara karidele
He runs fast.	se druta gatire daudanti
He runs fast.	se druta gatire daudanti
he runs. 	Siye daudu chi
he runs. 	Siye daudu chi
He said nothing.	se kichi kahile nahi
He sang and sang.	se gita gaai thile
He saved us all.	se aana samastanku rakhya kale
He saw the girl.	se jhiatiku dekhila
He screams a lot.	se bahut chitakara karanti
He seems honest.	se schhot manehuye
He seems hungry.	se bhokila mane hue
He seems hungry.	se bhokila mane hue
He seems ill.	se asustha thiba pari mane hue
He seems ill.	se asustha thiba pari mane hue
He sells radios.	se radio bikri karanti
He sells whisky.	se whisky bikri karanti
He shall have it.	se taha paaiebe
He shook my hand.	se mo sahita hata halaile
He shouts a lot.	se bahut pati karanti
He shut the door.	se kabata band kridele
He shut the door.	se kabata band kridele
He slept all day.	se dina sara soithile
He slept an hour.	se eka ghanta sooithile
He slept soundly.	se bhala bhabare sooile
he slept the whole night	say rati sara soithila
He speaks Arabic.	se aarbi kuhanti
He speaks French.	se farasi kuhanti
he spoke 	siye kahila
He stared at me.	se mo aadaku chain rahile
He studied hard.	se kathin adhyayana kale
he studies there	saiithi adhyayana karuchi
He told everyone.	se samastanku kahithile
He told everyone.	se samastanku kahithile
He told us a lie.	se aamaku mithya kahichanti
He took his book.	se tanka pustaka neithile
He took his time.	se tankara samaya neithithila\
he tries. 	Siye chesta karuchi
He turned around.	se bulipadithile
He turned around.	se bulipadithile
He used to drink.	se piuthile
He used to drink.	se piuthile
he used to stand for everything	se sabure asiki thiya haichi
He walks slowly.	se sdhire dhire chalanti
He wants to come.	se aasibaku chahuchanti
He was a popular politician. 	Se jane lokopriya rajaneta thile
He was acquitted.	se nirdesa re khalas hoithile
He was acquitted.	se nirdesa re khalas hoithile
He was alone.	se ekuthiya thile
He was alone.	se ekuthiya thile
He was born rich.	se dhaani hoithile
He was great.	se mahan thile
He was lucky.	se bhagyaban thile
He was naive.	se nirbodha thile
He was naive.	se nirbodha thile
He was naive.	se nirbodha thile
He was naive.	se nirbodha thile
He was naive.	se nirbodha thile
He was speaking.	se kahuthile
He was standing.	se thia hoithile
He was very old.	se bahut brudddha thile
He was wrong.	se bhul karithile
He was wrong.	se bhul karithile
He waved at her.	se ta upare haata bulaile
He waved at her.	se ta upare haata bulaile
He went surfing.	se surfing karibaku jaithile
He went surfing.	se surfing karibaku jaithile
he will come	say aasiba
He will come.	se aasibe
he will eat	say khaiba
he will go	say jiba
He will wait.	se apekhya karibe
he wont be there na	se nathiba na
He wore glasses.	se chasma pindhithile
He writes books.	se pustaka lekhanti
he wrote well in the examination	say pariksha bhala karichi
Head lice need to maintain contact with a host in order to survive .	Bachiba payi head ushugudik eka host sahita samparka bajaye rakhiba abashyak karanti
heelo!	namaskar
Helium is a gas.	Helium heuchi eka gas.
Hello	Namasc?¸ra
Hello	Namaskar
Hello bro.	Dada juhar
"Hello, girls."	"namaskar, jhiamane"
"Hello, Tom."	nomoskar tom
"Help me, please."	- Dayakari mate sahajya kara
help me.	 Mote sahajya kara
help me. 	Mote sahajya kara
Help Tom out.	Tom ku sahajya karantu
Help Tom out.	Tom ku sahajya karantu
Help Tom out.	Tom ku sahajya karantu
help tom.	 Tom ku sahajya kara
help us. 	Aamaku sahajya kara
help us. 	Aamaku sahajya kara
help!	sahajya kara!
Help!	sahajya!
help! 	sahayata kara!
Her book is red.	Tanka pustaka laal rangara.
Her face lit up.	Ta ra muha jali uthila
Her face lit up.	Ta ra muha jali uthila. 
Her father died.	Tanka pitankara mrutyu hoithila.
Her father died.	Tanka pitankara mrutyu hoithila
here	aithiki
Here he is!	se aathare aachonti
Here is the car.	Ethare car achi.
Here we go.	aathare aame thiba
Here you are.	eithi acha tume
Here you are.	eithi acha tume
"Here, take this."	Ethare ehaku niaa.
"Here, take this."	Ethare ehaku niaa.
Here's the plan.	Ethare jojana achi.
Here's your dog.	Ethare tumara kukura achi.
Here's your key.	Ethare tumara chabi achi
He's a bad liar.	se jane kharap mithyabadi
He's a bigot.	se jane bada loka
He's a comedian.	se jane haashya avineta
He's a frat boy.	se jane bhai balaka
He's a frat boy.	se jane bhai balaka
He's a gardener.	se jane bagicha
He's a good boy.	se jane bhala balaka
He's a good man.	se jane bhala manisa
He's a southpaw.	se eka dakhinapau
He's antisocial.	se antisocial atey
He's cruel.	se nisthoro
He's dead-tired.	se marijaichanti
He's dieting.	se dieting karuchanti
He's English.	se angrezi
He's going bald.	se bala jauchi
He's helping me.	se mate sahajya karuchanti
He's her friend.	se tankara bandhu
He's in pain.	se jantrana anubhaba karuchanti
He's in trouble.	se asubidhare achanti
He's lying.	se mytho kohuchonti
He's my brother.	se mora bhai
He's my hero.	se mora hero
He's not a hero.	se eka nayaka nuhe
He's not a liar.	se mithyabadi nuhanti
He's not stupid.	se murkha nuhanti
He's not stupid.	se murkha nuhanti
He's on his way.	se tanka raastare jauchanti
He's over forty.	Se chalish barsaru adhika.
He's paraplegic.	Se paraplegic ate.
He's photogenic.	Se photogenic.
He's smart.	se smart
He's Swiss.	se swiss
He's too old.	se bahut bridha
He's very angry.	Se bahut ragichanti.
He's wide awake.	Se bahut jagrata
"Hey, wait up!"	"hey, apekhya kara"
"Hey, wait up!"	"hey, apekhya kara"
"Hey, wait up."	"hey, apekhya kara"
Hey. I know you.	Hey mun tamaku jane.
Hi	Namaskar
Hi 	Namaskar
Highlight border color	sima rangakun higlight karantu
Highlight duration	samaya simakun higlight karantun
Hii my name is shreenandan 	Namaskar mo na shreenandan 
His ID was fake.	Tanka parichaya nakali thila.
His word is law.	Tankara bakya heuchi niyama
"his/her work, his/her studies"	ta kama ta patha
hit tom. 	Tom ku mara
hit tom. 	Tom ku mara
Hoist the sails!	Nabikagudika uparaku uthantu!
hold fire   	Niyan/agni ku dhari rakha
"Hold on, please."	Dayakari dharantu?
hold on. 	Ruha tike
hold on. 	Ruha tike
hold thid   	Eha kipari
Hold Tom for me.	Mo pain Tom dhari rakha
Honesty pays.	sachhtata pradaan kare
hop in 	hop in
How about 12:45?	Praya 12:45 kipari?
How about 12:45?	Praya 12:45 kipari?
How about 12:45?	Praya 12:45 kipari?
How about 12:45?	Praya 12:45 kipari?
How absurd!	kate absurd
How adventurous!	Kete du vent sahasika!
How are you ?	Tame kemiti acha ?
How are you all?	Tume samaste kemiti acha?
How are you now?	Aapana bartaman kemiti achanti?
How are you?	Tame kemiti acho?
How are you?	Tame kemiti acho?
How are you?	Tame kemiti acho? 
How are you? 	Tame kemiti acho? 
how awful  	kete bhayankar
How barbaric!	kete barbar
How big you are!	Tume kete bada!
How boring!	keete birokti kor
How can that be?	Taha kipari hoipare?
How can this be?	Eha kipari hoipare?
How clever!	kate chaturo
How clever!	kate chaturo
How clever!	keete chaturo
How could it be?	Eha kipari hoipariba?
how cute. 	Kete gulguliya
How dare you!	ete saahas tumara
How dare you!	ete saahas tumara
How did Tom die?	Tom kipari marigala?
How do I do that?	Tate kana karibaku heba
How do we begin?	- Aame kipari aarambha kariba?
How do we do it?	Aame eha ku kipari kariba?
How do you feel?	Tume kana anubhaba karucha?
How do you feel?	Tume kana anubhaba karucha?
How do you know?	Aapana kipari janibe?
how does it feel	kemiti laguchi
how else can we do this	aau kemiti karipariba aita ku
how else?	aau kemiti
How horrible!	kete bhayankara
How interesting!	Keteka interesting tuhalaprada!
How is everyone?	Samaste kipari achanti?
How is it going?	- Eha kipari chalichi?
how is it?  	kete bhayankar
How is the weather today ? 	Aaji ra paaga kemiti achi 
How is your dad?	- Tuma bapa kemiti achanti?
How is your dad?	- Tuma bapa kemiti achanti?
How kind of you!	Aapana kipari prakar!
How kind of you!	Aapana kipari prakar!
How kind of you!	-Aapana kipari prakar!
How kind of you!	Aapana kipari prakar!
How lovely!	keeete sundoro
how many times have I said you	kete thara kahichi
how much is a room for one person/ two people?	jame/Dui jana pain gote kahya kete  tanka padiba?
how much is this?	eita kete tanka
How much was it?	Eha kete thila?
How old are you?	Tumara bayasa kete?
How old are you?	Aapana nka bayasa kete?
How old are you?	Aapana nka bayasa kete?
How pathetic!	kete dukha dyaka
How romantic!	kete romantic
How silly of me!	Mora kete nirbodha!
How touching!	kete sparshakatar
How tragic!	kaate tragic
How was it?	aaeha kaamiti thila
How was your day?	Tama dina kemiti gala?
how weird!  	kete adbhut
how who knows	kemiti ke jani
How will it end?	Eha kipari sesa haba?
how will this happen	kemiti haba
how will you know	tu kemiti janibu
How's the water?	Pani kemiti achi?
How's your cold?	Tumara thanda kemiti achi?
How's your cold?	Tumara thanda kemiti achi?
How's your cold?	Tumara thanda kemiti achi?
How's your wife?	- Kipari ra tumbhara stree?
hug	alingan
hug	alingan
hug me	mate kundyaa
hug me	mate kundyaa
hug tom. 	Tom ku kundhao
hug tom. 	Tom ku kundhao
humans destroyed the commons that they depended on.	Manushyamane nirbhare karuthiba Commons ku nashta karidele
Hurry home.	gharo ku shigro jaa
Hurry home.	gharo ku shigro jaa
hurry up 	Jaldi kara
"Hurry up, child!"	Sighra pila!
"Hurry up, girls."	Girls mane sighra jao.
"Hurry up, girls."	Girls mane sighra jao.
I	Mu
i aam rich.	 Mu dhani
I abhor spiders.	Mun Spider ku ghruna kare
I ache all over.	Mun pura jantrana deuchi
I admire you.	mu aapananka prashansak atey
I admire you.	mu aapananka prashansak atey
I admit it.	mu aaehaku swikar karuchi
i agree. 	Mu manuchi
i agree. 	Mu manuchi
I almost won.	mu praya jitili
I am a boy.	mu ek baaloko
I am a Japanese.	Mun jane Japani.
I am a Japanese.	Mun jane Japani.
I am a man.	mu jone puroso
I am a man.	mu jone puroso
I am all right.	Mu badhia achi.
I am also eating 	Mu hube khaichi
I am angry	mu ragichi
I am angry on you	Mu tuma uppare ragichi
I am Anup Kumar Majhi .	Mu Anup Kumar Majhi ate .
I am ashamed.	mu lajjit
I am at home.	mu ghare achi
i am back. 	Mu aasi gali
I am baffled.	mu bismit
i am bald. 	Mu chanda
I am bored.	mu birokto
i am busy 	Mu byasta achi
i am busy   	Mun bohut byasta achi
I am busy today.	Mun aaji byasta achi
I am Chinese.	mu chinese
I am Chinese.	mu chinese
I am curious.	mu agrahi
I am dead tired.	Mu klant hei marigali.
I am dozing off.	Mu band karuchi.
i am eating .	Mun khauchi |
i am fat 	mu mota achi
i am fat. 	Mu mota
i am fat. 	Mu mota
I am filling the form.	Mu form varuchi.
I am fine	Mu Bhala achi
I am fine	mu bhala achi
I am fine	Mu bhala achi
I am fine	Mu thik achi
I am fine	Mun bhala achi.
i am fine   	Mun thik achi
"I am fine , Temple, where are you going, will you come to play, "	"Mu Bhala achi, Mandira, kwade jaucha, Khelliyaku asiba, "
I am fine.	Mu theek achchi.
I am fine. 	Mu bhala achhi
I am fine. 	Mu bhala achhi
i am fine. 	Mu thk achi
i am free. 	Mu aazad hei gali
I am from China.	Mu china ru asichi.
I am from Spain.	Mu spain ru asichi.
I am from Tokyo.	Mu tokyo ru asichi.
i am full 	Mora peta bhari gala
I am going 	Mu jauchi 
I am going to sleep.	Mun soibaku jauchi
I am going tommorow	mu kali jauchi
I am going.	Mu jauchi.
I am good	Mu bhala achi
I am good.	Mu bhala achi|
I am happy.	mu khusi oochi
I am happy.	mu khusi oochi
I am Harsh 	Mu Harsh
i am here	 Mu eithi achi
i am here  	Mun ethare achi
I am human.	mu moniso
I am in a hurry.	Mu sighra achi.
I am in Bangalore	Mu Bangalore re achi
I am in trouble.	Mu asubidha re achi
I am injured.	mu aaghat paichi
I am injured.	mu aaghat paichi
I am Italian.	mu italian
I am Italian.	mu italian
i am late	 mote deri hauchi
I am learning odia	Mu odia seekhuchi
I am leaving	mu jaavuchi
I am married.	mu bibahita
I am not fine. 	Mu bhala nahi. 
I am not hungry.	Mu bhokila nahi.
i am okay 	 Mun thik achi
i am okay 	mu bhala achi
i am okay. 	Mu thk achi
i am old. 	Mu budha / budhi
i am old. 	Mu budha / budhi
I am praying.	mu prarthana karuchi
I am ready.	mu prostut oochi
I am ready.	mu prostut oochi
I am ready.	mu prostut oochi
I am really too busy today	Mu aaji satare bahut byasta achi
I am right.	mu thik oochi
I am right.	mu thik oochi
i am sad. 	Mora mana dukha
i am sad. 	Mora mana dukha
i am shy. 	Mu laja karuchi
i am shy. 	Mu laja karuchi
I am sick.	Mu asustha achi.
i am sick. 	Mora deha kharab achi
I am sleeping	Mu soichhi
I am sleepy	nida laguchi
I am so happy that you give me a another chance	Mun bahut khusi je tume mate ditiya sujoga dela
I am speechless.	Mu nirab ate.
i am sure  	Mun nichinta achi 
i am tall    	Mun lamba achi
i am tall. 	Mu lamba achi
I am thinking	mu bhabuchi
I am thirsty.	mu shoshila
I am thirsty.	mu shoshila
I am tired.	mu klanti ochi
i am ugly 	Mu asundar
I am undressing.	Mu anabrut karuchi.
I am undressing.	Mu anabrut karuchi.
I am very happy today	mu aaji bahut kush achii
I am very happy today.	Mu aaji bahut khushi achhi.
I am very happy.	Mu bahut khusi.
I am very sorry.	Mu bahut dukhat.
I am very tired.	Mu bahut klant.
i am weak   	Mun durbala achi
i am well  	 Mo swasthya thik achi
I am working.	Mu kama karu achhi.
I am your dad	mu to bopa
I apologized.	mu khyama magili
I appreciate it.	Dhanyabaad.
I asked Tom why.	Mu tom ku kahinki pacharili.
I ate caviar.	mu caviar khaili
I ate the apple.	Mu apple khaili.
I ate the apple.	Mu apple khaili.
I beg to differ.	Mu bhinna hebaku anurodh kre.
I beg to differ.	Mu bhinna hebaku anurodh kre.
I beg to differ.	Mu bhinna hebaku anurodh kre.
I bet that hurt.	Mu aghata deichi.
I bit my tongue.	Mu mo jibhaku kamudili.
I booked a seat.	Mu ek seat book kali.
I bought a book.	Mu ek bahi kinili.
I burp a lot.	mu bahut phatijaye
I called him up.	Mu taanku dakili.
I called him.	mu taanku dakili
I called Tom up.	Mu tom up ko dakili.
I called Tom up.	Mu tom up ku dakili.
I called Tom.	mu Tom ku daakili
I called Tom.	mu Tom ku phone kali
I can afford it.	Mu ehaku sambhali paribi.
I can afford it.	Mu ehaku sambhali paribi.
I can afford it.	Mu ehaku sambhali paribi.
I can do it now.	Mu bartamaan eha kari paribi.
i can fly   	Mun udi paribi
i can go. 	Mu jai paribi ki
I can handle it.	Mu ehaku sambhali paribi.
i can run   	Mun daudi paribi
I can see smoke.	Mu dhuan dekhipare.
I can sing.	mu gito gaayi paaribi
I can swim.	mu tahira paribe
I can try it.	mu ehaku chesta kari paribi
I can wait.	mu apecha kariparibe
I can't be late.	Mu bilamb kari paribi naahi.
I can't be late.	Mu bilamb kari paribi naahi.
I can't breathe.	Mu nikhwas nei paru nahi.
I can't deny it.	Mu ehaku aswikaar kari paribi nahi.
I can't do that.	Mu taha kariparibi nahi.
I can't do that.	Mu taha kariparibi nahi.
I can't do that.	Mu taha kariparibi nahi.
I can't do this.	Mu eha kari paribi nahi.
I can't do this.	Mu eha kari paribi nahi.
I can't draw.	mu chitra aanki paribi nahi
I can't go back.	Mu pheri paribi nahi.
I can't go home.	Mu gharaku jaai paribi naahi.
I can't go home.	Mu gharaku jaai paribi naahi.
I can't go.	mu jaayi paribi nahi
I can't hear it.	Mu eha suni paru naahi.
I can't hear it.	Mu eha suni paru naahi.
I can't help it.	Mu eha ku sahajya kari paribi nahi.
I can't help it.	Mu eha ku sahajya kari paribi nahi.
I can't help it.	Mu eha ku sahajya kari paribi nahi.
I can't help.	mu sahajya kari paribi nahi
I can't leave.	mu chadi paribi naahi
I can't move.	mu ghunchi paribi nahi
I can't read.	mu padhi paru nahi
I can't risk it.	Mu ehaku bipadre paakai paribi nahi.
I can't see Tom.	Mu tom ku dekhiparu naahi.
I can't see Tom.	Mu tom ku dekhiparu naahi.
I can't see you.	Mu tamaku dekhiparu naahi.
I can't sing.	mu geeta gaayi paribi nahi
I can't sleep.	mu soiparibi naahi
I can't smoke.	mu dhurma paan kariparibi naahi
I can't speak this language	mu ye bhasa jani ni
I can't speak this language.	Mun ye bhasha jani ni.
I can't stand.	mu thia hoipaare naahi
I can't stay.	mu rahi paribi nahi
I can't swim.	mu pahari paribi nahi
I can't talk.	mu kathabarta kari paribi nahi
I cant understand what you are saying	tama katha kichi bujha paduni
I can't undo it.	Mu ehaku purbabata kariparibi naahi.
I can't wait.	mu apekhya kariparibi nahi
I can't walk.	mu chaliparibi nahi
I can't watch.	mu dekhiparu naahi
I caught a cold.	Mu thandaa anubhab kali.
I caught a fish!	Mu ek maach dharili.
I caused this.	mu eha ghataili
I contributed.	mu sahajog karichi
I cooked dinner.	Mu ratri bhojan randhili.
I couldn't move.	Mu ghunchi parili naahi.
I couldn't stop.	Mu atkaai parili naahi.
I couldn't wait.	Mu apeksha kariparili naahi.
I couldn't wait.	Mu apeksha kariparili naahi.
I couldn't walk.	Mu chali parili naahi.
I cry every day.	Mu pratidin kaanduchi.
I cut myself.	mu nijaku katili
I cycle to work.	Mu kaam karibaaku chakra kare.
I deserved it.	mu eha jogya ate
i did it. 	Mu kari deli
I did nothing.	mu kichi kari naahi
I didn∆t eat anything	mu kichi khaini
I didn't lie.	mu micha kahili nahi
I didn't like it.	Mote eita bhala laagilaani.
I didn't listen.	Mu sunili naahi.
I didn't look.	mu dekhili naahi
I didn't pay.	mu deya deyi nahi
I didn't swim.	mu pahanrili naahi
I didn't win.	mu jitili nahi
I do hope so.	mu asha kare
I do hope so.	mu asha kare
I do like you.	mu tumaku pasand kare
I do my best.	mu mora jatasambhaba chesta kare
I do that a lot.	Mu taaha bahut kare.
I do think so.	mu bhabuchi
I do want it.	mu eha chahe
I don∆t know	mu janini 
I don∆t want to see you	mu tate dekhibaku chahuni
I don't agree.	mu raaji nuha
I don't care.	mora dhyana nahi
I don't care.	mora dhyana nahi
I don't dream.	mu sapna dekhe naahi
I don't drink.	mu piunaahi
I don't know	mu jani nahi
I don't know 	Mu jaani naahi
I don't know.	mu jani nahi
I don't know.	mu jani nahi
I don't know.	mu jani nahi
I don't like it.	Mu ehaku pasand kare naahi.
I don't like to study	Mate padhibaku bhaka lageni
I don't mind.	mora kichchi aapatti nahi
I don't mind.	mora kichchi aapatti nahi
I don't need it.	Mor eha darkaar naahi.
I don't need it.	Mor eha darkaar naahi.
I don't see him.	Mu taanku dekhe naaahi.
I don't see why.	Mu dekhu naahi kahinki.
I don't see why.	Mu dekhu naahi kahinki.
I don't see you.	Mu tumaku dekhe naahi.
I don't sing.	mu geet gau nahi
I don't snore.	mu kahunahi
I don't understand	mun bujhi paruni
I don't wanna write 	Mun lekhibaku hin chahun ni 
I don't want it.	Mu eha chahe naahi.
I don't want it.	Mu eha chahe naahi.
I don't want it.	Mu eha chahe naahi.
I don't want it.	Mu eha chahe naahi.
I drank milk.	mu kheera pieli
I dream a lot.	mu bahut sapna dekhe
I eat cheese.	mu paneer khaye
I eat here.	mu aethare khae
I enjoy chess.	mu chess upabhoig kare
I enjoy life.	mu jeebanaku upabhoga kare
I enjoy life.	mu jeebanaku upabhoga kare
I enjoy music.	mu sangiuta ku upabhog kare
I enjoy reading.	Mu padhibaku bhala paye.
I envy her.	mu taaku irsya koree
I envy him.	mu  taaku irsya kare
I envy Tom.	mu tom ku irsya kore
I escaped death.	Mu mrutya ru raksha paili.
I escaped death.	Mu mrutya ru raksha paili.
I exaggerated.	mu atyadhik matra re
I expect to win.	Mu jitibaku asha kare.
i fainted   	Mun achetana hoipadili
i fear so   	"Mate daralaguchi, sethipain"
I fed the dog.	mu kukuraku khaibaku deli
I feel alive.	mu jeebanaku upabhoga kare
I feel dizzy.	mo munda bulayuchi
I feel dizzy.	mo munda bulayuchi
I feel dizzy.	mo munda bulayuchi
I feel feverish.	Mu juar anubhab karuchi.
I feel great.	mu bahut bhala anubhaba karuchi
I feel great.	mu bahut bhala anubhaba karuchi
I feel guilty.	mu nihajku sodhi anubhab karuchi
I feel happy.	mu khusi anubhaba karuchi
I feel helpless.	Mu asahaya anubhab karuchi.
I feel homesick.	Mu gharaku ghor anubhab karuchi.
I feel horrible.	Mu bhayamit anubhab karuchi.
I feel it now.	mu bartabaan ehaku anubhab karuchi
I feel my age.	mu mora bayasa anubhab karuchi
I feel old.	mu bridho anubhavo karonti
I feel queasy.	mu birakta anubhab karuchi
I feel strong.	mu shakti shaali anubhab karuchi
I feel stupid.	mu murkha anubhab karuchi
I feel terrible.	Mu bhayankar anubhab karuchi.
I feel terrific.	Mu bhayamit anubhab karuchi.
I feel the same.	Mu madhya samaan anubhab karuchi.
I feel very ill.	Mu bahut aswasth anubhab karuchi.
i fell	mu padigali
i fell 	mu padigali
I fell asleep.	mu soi padili
I felt betrayed.	Mu biswasghaat kata anubhab kali.
I felt hungry.	mu bhokila anubhab karuchi
I felt isolated.	Mu bicchalin anubhab kali.
I felt isolated.	Mu bicchalin anubhab kali.
I felt left out.	Mu anubhab kali.
I felt left out.	Mu anubhab kali.
I felt lonely.	mu ekutia anubhab kali
I felt naked.	mu ulagna anubhaba kali
I felt relieved.	Mu aaram paili.
I forgave Tom.	mu tomku khyama karideli
I found it.	mu paaeli
I found it.	mu paaeli
I found them.	mu semananku paili
I found these.	mu aegudiku paaili
I freaked out.	mu chamki gali
I fuck you. 	Mu tumaku gihae. 
I get peace while walking	Mate calile santi mile
I get the point.	Mu bandu paili.
I get up at six.	Mu cha ta bele uthe.
i get you  	Mun tama katha bughili
I go	mu jaye
I go every year.	Mu prati barsh jaye.
I go jogging.	mu jogging ku jaye
I go to Kyoto.	mu kyoto ku jaae
I go to work.	mu kaama ku jaye
I got an A.	mu eko a paaeli
i got it. 	Mu mili gala
I got married.	mu bibaha kali
I got no answer.	Mor kaunasi uttara naahi.
I got the flu.	mu flu paili
I guessed right.	Mu thik anumaan kali.
I had doubts.	mora sandeha thila
I had thought	mu bhabithili
I had to hide.	mate luchi baku padila
I had to work.	mate kaama karibaku padi;a
I had told you na	mu kahithili na
I hate children.	Mu pila manaku ghrina kare.
I hate coffee.	mu cofee ku hate kare
I hate everyone.	Mu samastanku ghrina kare.
I hate French.	mu french ku ghruna kare
I hate funerals.	Mu antim sanskaaranku ghrina kare.
I hate liars.	mu mithyabadimananku ghrina kare
I hate losing.	mu haribaku ghruna kare
I hate my job.	mu mora kaama ku ghruna kare
I hate myself.	mu nijaku ghruna kare
I hate politics.	Mu rajneetinku ghrina kare.
I hate raccoons.	Mu raccoon ku ghrina kare.
I hate reptiles.	 Mu sarishrapmaananku ghrina kare.
I hate reptiles.	 Mu sarishrapmaananku ghrina kare.
I hate shopping.	Mu shopping ghrina kare.
I hate sushi.	mu sishuku ghrina kare
I hate the cold.	Mu thandaku ghrina kre.
I hate this job.	Mu ehi kaam ku ghrina kare
I hate this rug.	Mu ehi gaamuchaku ghrina kare.
I hate this rug.	Mu ehi gaamuchaku ghrina kare.
I hate Tom.	mu tom ku ghrina kore
I hate winter.	mu sita ku ghruna kare
I have a book.	Mo pakhare bahitiee achi
I have a book.	mora eka bahi achi
I have a car.	mora eka car achi
I have a cold.	mote thanda heijaichi
I have a date.	mora eka taarekh achi
I have a dog.	mora gotiye kukura achi
I have a family.	Mor ek paribaar achi.
I have a home.	mora eka ghara achi
I have a pen.	mora gotiye kukura achi
I have a phone.	Mo pakhare gote phone achi.
I have a theory.	Mor  ek  sidhaanta achi.
I have a twin.	mora eka jaanla sisu achi
I have a visa.	mora visa achi
I have a wife.	mora eka stree achi
I have an egg.	mora eka anda achi
I have brothers.	Mor bhai maane achanti.
I have diabetes.	Mor madhumeh achi.
I have doubts.	mora sandeha achi
I have dry skin.	Mor suska charma achi.
I have failed.	mu biphala heuchi
I have heard the story	mu katha sunichi
I have hives.	mora hives achi
I have money.	mora tanka achi
I have no fever.	Mor juar naahi.
I have no horse.	Mor ghoda naahi.
I have no money.	Mor tanka naahi.
I have returned.	Mu pheri asichi.
I have sinned.	mu papa karici
I have ten pens.	Mor dasati kalam achi.
I have the keys.	Mor chaani achi.
I have to hurry!	Mate sighra jibaaku padiba.
I have to sleep.	Mate soyi baaku padiba.
I have to study.	mate adhyayan karibaaku padiba.
I have to think.	Mate chinta karibaku padiba.
I have to think.	Mate chinta karibaku padiba.
I have to try.	mote chesta karibaku padiba
I have to win.	mote jitibaku padiba
I have two cars.	Mor duiti car achi.
I have two cats.	Mor duiti car achi.
I hear music.	mu sangeet sunuchi
I hear only you.	Mu kebal tumaku sunuchi.
I hear the drum.	Mu drum sunuchi.
I hear voices.	mu swara sunuchi
I hear you.	 mu tumoku sunuchi
I hear you.	mu tumoku sunuchi
I hear you.	mu tumoku sunuchi
I hear you.	mu tumoku sunuchi
I hear you.	mu tumoku sunuchi
I heard a noise.	Mu ek sound sunili.
I heard it.	mu aaeha sunuchi
I heard it.	mu aaeha sunuchi
I helped Tom.	mu Tomku sahajya kali
I hope it works.	Mu asa kare eha kaam kare.
I hope not.	mu aasa kore naahi
i hope so   	Mate laguchi
I hope Tom wins.	Mu asa karuchi tom jitiba.
I hugged her.	mu tanku alingana kali
I hugged her.	mu tanku alingana kali
I hugged Tom.	mu Tom ku alingana kali
I hugged Tom.	mu Tom ku alingana kali
I hurt my elbow.	Mu mor konaku aghaat kali.
I improvised.	mu improvise kali
I improvised.	mu improvise kali
I intend to try.	Mu chesta karibaaku iccha kare.
I just found it.	Mu ehaku paili.
I just found it.	Mu ehaku paili.
I just found it.	Mu ehaku paili.
I just got up.	mu bartamaan uthili
I just moved in.	Mu bartamaan bhitaraku gali.
I just showered.	Mu kebal gadheili.
I keep a dog.	mu gotiye kukura rakhe
I keep sneezing.	Mu chinkiba jaari rakhe.
i kept it for you	mu to pain rakhichi
I kid you not.	mu tumaku pila nuhe
i knew it   	Mun janithili
I knew the risk.	Mu bipad jani thili.
I knew Tom well.	Mu tom ku bhala bhabe jani thili.
I knew too much.	Mu bahut jani thili.
I knew we'd win.	Mu jaani thili aame jitiba.
i know	mu janichi
I know her well.	Mu taanku bhalabhaabe jaane.
I know her.	mu taaku jaane
I know people.	mu loka mananku jaane
I know the area.	Mu sehi anchal jaanichi.
I know the girl.	Mu jhiya ku jaane.
I know them all.	Mu se samastanku jaane.
I know too much.	Mu bahut jaane.
I know you.	mu tomoku jaane
I know your son.	Mu tama pua ku jaane.
I know your son.	Mu tama pua ku jaane.
i laughed   	Mun hasideli
I learn Turkish.	Mu turkey sikhe.
I left the room.	Mu room ru bahari gali.
i lied	mu micha kahithili
I like apples.	mu apple pasand kare
I like baseball.	Mu baseball pasand kare.
I like cake	Mate cake pasand
I like cartoons.	Mu cartoon pasand kare.
I like cartoons.	Mu cartoon pasand kare.
I like China.	mu China pasanda kare
I like clocks.	mu ghanta pasand kare
I like football.	Mu football pasand kare.
I like French.	mu french pasand kare
I like girls.	mu jhiamananku pasanda kare
I like him.	mu taaku posond kare
I like horses.	mu ghoda pasand kare
i like it    	Mate bhala lagila
I like movies.	mu chalachitra pasand kare
I like my house.	Mu mo gharaku pasand kare.
I like my job.	mu mora kama pasand kare
I like pizza.	mu pizza pasanda kare
I like red wine.	Mu lal mad pasand kare.
I like skiing.	mu skiing pasand kare
I like sleeping.	Mu soibaaku pasand kare.
I like spoons.	mu chamach pasand kare
I like sports.	mu khela pasand kare
I like spring.	mu basant  pasand kare
I like sushi.	mu sishu pasand kare
I like sweets.	mu  meetha pasand kare
I like tea.	 mu cha posond karee
I like tennis.	mu tennis  pasand kare
I like that tie.	Mu sehi tie ku pasand kare.
I like them all.	Mu seshbuku pasand kare.
I like this cup.	Mu ehi cup pasand kare.
I like this dog.	Mu ehi kukuraku pasand kare.
I like this dog.	Mu ehi kukuraku pasand kare.
I like this job.	Mu ehi kaam pasand kare.
I like this tea.	Mu ehi cha ku pasand kare.
I like to dance.	Mu nachibaku pasand kare.
I like to dream.	Mu swapna dekhibaku pasand kare.
I like to eat.	mu khaibaku  pasand kare
I like to run.	mu doudibaaku pasand kare
I like trains.	mu train  pasand kare
I like winter.	mu sitaku  pasand kare
I like women.	mu mahilamananku pasand kare
"I like you, too."	Mu b tumaku pasand kare.
I like you.	mu tumoko posond kare
I like you.	mu tumoko posond kare
I like your car.	Mu tuma car ku pasand kare.
I like your car.	Mu tuma car ku pasand kare.
I like your car.	Mu tuma car ku pasand kare.
I like your car.	Mu tuma car ku pasand kare.
I like your car.	Mu tuma car ku pasand kare.
I like your hat.	Mu tamar topi pasand kare.
I like your hat.	Mu tamar topi pasand kare.
I like your hat.	Mu tamar topi pasand kare.
I like your way of speaking	Mote tumara katha kahiba shaili bhala lage
I live in Japan.	Mu japan re rahe.
I live in Rourkela 	Mu Rourkela re rahuchi
I lived in Rome.	Mu rome re rahu thili.
I look like Tom.	Mu tom pari dekha jaichi.
I looked at Tom.	Mu tom ku chahili.
I looked down.	mu talaku dkhili
i lost	mu harigali
I lost a bet.	mu eka baji harigali
I lost a bet.	mu eka baji harigali
I lost my bag	mo bastani haji gala
I lost my bag.	Mo bastani haji gala.
I lost my key.	m\
I lost my key.	mu mora chaabi haraideli
I lost my purse	mo purse haji gala
I lost that bet.	Mu sehi baaji haraili.
I love Arabic.	mu arabic bhala paae
I love autumn.	mu sarata bhala paare
I love books.	mu bahigudika bhala paye
I love chicken	Mote chicken bhala lage
I love coffee.	mu cofeebhala paare
I love comedies.	Mu haasya abhinay ku bhala paye.
I love French.	nu french bhala paae
I love games.	mu khela ku bhala paye
I love garlic.	mu rasuna ku bhala paare
I love her.	mu taaku bholo paaye
I love him.	mu taanku bholo paaye
I love horses.	mu ghodaaku bhala paare
I love jokes.	mu thathaku bhala paye
I love Monday!	mu sombaraku bhala paare
I love movies.	mu movies ku bhala paare
I love my son.	mu mo puaku bhala paare
I love myself	Mu nikal bhala paye
I love nature.	mu prakrutiku bhala paare
I love pandas.	mu pandanku bhala paare
I love pizza.	mate pizza pasand achi
I love pizza.	mu pizza ku bhala paye
I love sports.	mu khela ku bhala paare
I love the idea.	Mu dhaarna ku bhala paye.
I love to dance.	Mu nachibaku bhala paye.
I love to dance.	Mu nachibaku bhala paye.
I love to party.	Mu bhoji karibaaku bhala paye.
I love to play	Mu khelibaku bhala pae
I love to sleep	Mate soibaku bhala lage
I love Tom.	mu tom ku bholo paaye
I love trips.	mu jatraku bhala paye
I love weddings.	Mu bibah ku bhala paye.
I love you	Mu tamaku bhala paaye
I love you	Mu tamaku bhala paye
I love you	mu tamaku bhalla pauchi
I love you	Mu tamaku prema kare
I love you	Mu tumaku bhala pae
I love you	Mu tumaku bhala paye
I love you	Mun tumaku bhala pae
I love you 	Mun tumaku bhala Pai 
"I love you, Tom."	Mu tumaku bhala paye.
I love you.	Mu tamaku bhala pae.
I love you.	mu tumoko bholo paaye
I love you.	mu tumoko bholo paaye
I love you.	mu tumoko bholo paaye
I love you.	mu tumoko bholo paaye
I love you.	Mun tumaku bhalapai.
I love your car.	Mu tuma car ku bhala paye.
I love your son.	Mu tuma puaku bhala paye.
I love your son.	Mu tuma puaku bhala paye.
I loved that.	mu ehaku bhala pauthili
I m a full time travel content creator 	Mu bhuli saha video banaye
I made a bet.	mu eka baaji lagaili
I made a fist.	mu thenga tiari kali
I made a list.	mu eka talika prastusta kali
I made coffee.	mu coffee tiyari kali
I made dinner.	mu ratri bhojana kali
I made supper.	mu ratri bhojana kali
I made supper.	mu ratri bhojana kali
I married Tom.	mu tomaku bibaha kali
i mean it   	Mun Mun ehara artha
"I mean, at that time, trust me,"	Mora arth sehi samayare mote viswas kara
I meant no harm.	Mor kaunasi khati na thila.
I meant no harm.	Mor kaunasi khati na thila.
I meant no harm.	mora kaunasi khyati nathila
I met her again.	mu puni taanku bhetili
i met him   	Mun taku dekha krili
I might be back.	mu pheri aasipaare
I miss my mom.	mu mo maa ku mane pakauchi
I miss the army.	mu senaku mane pakauchi
I miss you.	mu tumoko moone pokaaye
I miss you.	mu tumoko moone pokaaye
I miss you.	mu tumoko moone pokaaye
I miss you.	mu tumoko moone pokaaye
I missed you.	mu tumaku mane pakauthili
I misunderstood.	mu bhul bujhili
I misunderstood.	mu bhul bujhili
I must be blind.	mu nishchaya andha
I must find out.	mu nishchaya khojibi
I must find Tom.	mu nishchaya Tom ku paibi
I must go alone.	mu nishchaya ekhuthiya jibi
I must go now.	mu bartomana jibi
I must go now.	mu bartomana jibi
I must go out.	mu nishchaya baharaku jibi
I must go there.	mu nishchaya sethaku jibi
I must help her.	mu nishchaya tanku sahajya karibi
I must help him.	mu taanku sahajya kariba jaruri
I must hurry.	mate shighra jibaku padiba
I must hurry.	mu shighra jibaku padiba
I must obey Tom.	mu nishchaya Tom ku manibi
I must resist.	mu nishchaya baharaku jibi
I must resist.	mu nishchaya baharaku jibi
I must see it.	mu nishchaya ehaku dekhibi
I must study.	mu nishchay adhyayana karibi
I must warn him.	mu nishchay atanku chetabani debi
I nearly died.	muh praya marigali
I need a bucket.	mora eka balti darkaar
I need a doctor	dakatara ku daka
I need a doctor.	mora jane doctor darkaar
I need a hammer.	mora hathudi darkaar
I need a hug.	mote alingana darkaar
I need a job.	mora chakiri darkaar
I need a lawyer.	mora jane wakil darkaar
I need a loan.	moro eka loan darakara
I need a map.	mora eka maanachitra darkaar
I need a map.	mote eka maanachitra darkaar
I need a tissue.	mora eka tissue daekaar
I need coffee.	mu coffee abhshyaka
I need his help.	mu taankara sahajya abashyaka kare
I need ice.	moro borofo dorkaro
I need Internet.	mote internet darkaar
I need it today.	mote aji darkaar
I need money.	mora tanka darkaar
I need somebody.	mora kehi darkaar
I need the keys.	mora chabi darkaar
I need this job.	mora ehi kaam darkaar
I need to focus.	mu dhyan deba abashyaka
I need to relax.	mote aaram karibaku padiba
I need to shave.	mote shave karibaku padiba
I need water.	mote paani darkaar
I need you.	mu tumoku chahe
I need you.	mu tumoku chahe
I need you.	mu tumoku chahe
I need your help	mate tuma sahajya darkar
I need your help.	Mate tuma sahajya darkar.
I never do that.	mu taha kebe kare nahi
I never do that.	mu taha kebe kare nuhe
I never drink.	mu kadapi piyebi nahi
I never give up.	mu kebe haar manibi nahi
I never hit Tom.	mu Tom ku kadapi marili nahi
I never said no.	mu kadapi kahi nahi
I never was shy.	mu kebe laja kare nahi
I often read.	mu prayataha padhithaye
I often see him.	mu tanku prayataha dekhe
I only need Tom.	mote kebala Tom darkaar
I only want Tom.	mu kebala Tom chahuchi
I ordered pizza.	mu pizza order kali
I owe Tom money.	mu Tom ku tanka owe kare
I own a horse.	moro eka ghoda achi
I paid my bills.	mu mora bill jama kali
I paid the bill.	mu bill jama kali
I panicked.	mu bhayobhit haali
I phoned him.	mu taanku phone kali
I play piano.	mu piano bajaye
I play tennis.	mu tennis khele
I play violin.	muh bhailin bajaye
I play with him.	mu taanka sahita khele
I played tennis.	mu tennis khelili
I prefer coffee.	mu coffee pasand kare
I prefer coffee.	mu coffee pasand kare
i promise   	Mun pratigyan kruchi
I promised.	mu protigya korithile
I put it back.	mu ehaku pherai deli
I quite agree.	mu sampurna sahamata
I ran outside.	mu bahare doudili
I read a book.	mu eka bahi padhili
I read a book.	mu eka bahi padhili
I read a letter.	mu eka chitthi padhili
I read a lot.	mu bahut padhichi
I read his book.	mu taanka pustaka padhili
I read the book.	mu bahi padhili
I read the book.	mu pustaka padhili
i refuse. 	Mu mana karuchi
I relied on him.	mu taanka upare nirbhara kali
I relied on him.	mu taanka upare nirbhara kali
I remember them.	mu semananku mane rakhichi
I remember them.	mu semananku mane rakhichi
I remember.	moro moone aachi+
I remembered it.	mora mane padigali
I rescued her.	mu tanku uddhar kali
I rescued him.	mu tanku uddhar kali
I rescued you.	mu tamaku uddhar kali
i resign 	Mu isstifa deli
I resigned.	mu isstifa daale
I resigned.	mu isstifa daale
I run every day.	mu pratidina daude
I said thanks.	mu dhanyabada kali
I sat down.	mu bosile
I saw a mouse!	mu eka mus dekhili
I saw a plane.	mu eka vimana dekhili
I saw a plane.	mu eka vimana dekhili
I saw her again.	mu tanku puni dekhili
i saw him   	Mun taku dekhili
I saw him again.	mu tanku puni dekhi li
I saw him first.	mu tanku prathame dekhili
I saw him there.	mu tanku prathame dekhili
I saw it coming.	mu dekhili eha asuchi
I saw it coming.	mu dekhili eha asuchi
I saw it coming.	mu dekhili eha asuchi
"I saw it, too."	mu madhya eha dekhili
I saw nothing.	mu kicchi dekhili nahi
I saw nothing.	mu kicchi dekhili nahi
I saw someone.	mu kahaku dekhili
I saw something.	mu kichi dekhili
I saw that.	mu taha dekhili
I saw the film last  week	mu gata saptaha re chalachitra ti dekhili
I saw the movie.	mu chalachitra dekhili
I saw them.	mu semanonku dekhili
I saw Tom leave.	mu dekhili Tom chalijauchi
I saw Tom naked.	mu Tom ku ulagna dekhili
I saw Tom on TV.	mu Tom ku TV re dekhili
i saw you  	 Mun tamaku dekhili
I saw you there.	mu tumaku sethare dekhili
I saw you there.	mu tumaku sethare dekhili
I see a book.	mu eka bahi dekhuchi
I see a crown.	mu eka mukuta dekhuchi
I see a giraffe.	mu eka giraffe dekhuchi
I see a house.	mu eka ghaara dekhucgi
I see a lion.	mu singh lion dekhuchi
I see a star.	mu eka tara dekhe
I see something.	mu kichi dekhuchi
I see the boy.	mu pilatilu dekhili
I shook my head.	mu munda haleili
I should go now.	mu bartamaan jiba uchit
I slapped him.	muh tanka chapuda marili
I smelled bacon.	mu bacon gandha kali
i smiled. 	Mu muchuki muchuki hasili
I sold a book.	mu eka bahi bikari kali
I speak English.	mu angrezi kahe
I speak Swedish.	mu swedish kahe
i stayed. 	Mu rahili
I study English.	mu angrezi adhyayana kare
I supported him.	mu tanku samarthana kali
I suppose so.	mu bhabuchi
I survived.	mu bochigoli
I survived.	mu bochigoli
I swim a lot.	mu bahut gadhouchi
I sympathize.	mu samabedana janauchi
I sympathize.	mu samabedana janauchi
I sympathize.	mu samabedana janauchi
I talk a lot.	mu bahut kathabarta kare
I teach Chinese.	mu chinese sikhya diye
I teach English.	mu angrezi sikhya diye
I teach Spanish.	my spanish sikhya diye
I think her face has swollen	mate laguchi ta muha fulli jauchi
I think I agree.	u bhabuchi eha raazi achi
I think I can.	mu bhabuchi mu kariparibi
I think it's OK.	mu bhabhuchi eha thik ache
I think it's OK.	mu bhabhuchi eha thik ache
"I think so, too."	mu madhya bhabuchi
"I think so, too."	mu madhya bhabuchi
"I think so, too."	mu madhya bhabuchi
I think so.	mu bhabi chi
I thought so.	mote seiya lagila
I thought so.	mote seiya lagila
I threw up.	mu phompadi daele
I threw up.	mu phompadi daele
I threw up.	mu phompadi daele
I told you so.	mu tamaku kahili
I told you so.	mu tamaku kahili
I too wanted so	moro bhi icha thila
I took a shower.	mu gadhoili
I took a shower.	mu gadhoili
I took a walk.	mu bulili
I took her home.	mu taku ghaarku neigali
I tried to help.	mu sahajya karibaku chesta kali
I trust you all.	mu toma samastanku bishwasa kare
i try	mu chesta kare
I understand.	mu bujhili
i use it. 	Mu byabahara karuchi
I used to a lot.	mu tomaku byabahara karuthili
I volunteered.	mu swecchakrita bhabe
I volunteered.	mu swecchakrita bhabe
I voted for Tom.	mu tam pai vote deli
I voted for you.	mu tomaku vote deli
I voted for you.	mu tomaku vote deli
i waited 	mu apkesha karili
I want a beer.	mu eka beer chahuchi
I want a book.	mu eka bahi chahuchi
I want a family.	mu ek pariwaara chahuchi
I want a guitar.	mu ek giutar chahuchi
I want a job.	mu chakiri chahuchi
I want a lawyer.	mu jane vokil chahuchi
I want a lot.	mu bahut chahichi
I want a pony.	mu eka pony chahuchi
I want a pool.	mu ka pool chahuchi
I want a refund.	mu fairasta karibaku chahuchi
I want a Toyota.	mu ek toyota chahuchi
I want an apple.	mu ek apple chahuchi
I want facts.	mu tathya chahichi
I want money.	mu tanka chahichi
I want my mommy.	mu mora mummy chahuchi
I want my money.	mu mora tonka chahuchi
I want one!	mu gotiye chahe
I want one!	mu gotiye chahe
I want one!	mu gotiye chahe
"I want one, too."	mu madhya gotiye chahuchi
"I want one, too."	mu madhya gotiye chahuchi
"I want one, too."	mu madhya gotiye chahuchi
I want proof.	mu pramaan chahuchi
I want proof.	mu pramaan chahuchi
I want that one.	mu taha chahe
I want the best.	mu sarwottama chahuchi
I want the same.	mu madhya samana chahuchi
I want the same.	mu madhya samana chahuchi
I want them all.	mu sesabu chahe
I want to become a drunkard 	Mun gote madua habaku chahunchhi
I want to check out	mu check out karibaku chahen
I want to cry.	muh kandhibaku chahuchi
I want to dance.	mu nachibaku chahe
I want to die.	mu maribaku chahe
I want to dream.	mu swapana dekhibaku nahi
I want to drive.	mu gaadi chalaibaku chahuchi
I want to eat.	mu khaibaku chahuchi
I want to go.	mu jibaku chahe
I want to know about your concept. 	Mu tumara lakya ku janinaku chahe
I want to learn.	mu sikhibaku chahe
I want to read this book	mu ehi bahi ti padhiba pal cahuchi
I want to rent a car	mo gotaye car bhada karibaku chahnee
I want to sleep.	mu soibaku chahuchi
I want to try.	mu chesta kariubaku chahe
I want to win.	mu jiti baku chahuchi
I want to win.	mu jiti baku chahuchi
I want you here.	mu tamaku eithare chahuchi 
I want you.	mu tomoku chhahe
I want you.	mu tomoku chhahe
I wanted more.	mu adhika chahuthili
I wanted this.	mu eha chahuthili
I wanted to cry.	mu kandibaku chahuthili
I was a fool.	mu murkha thili
I was a teacher.	mu jane shikhykha thili
I was a witness.	mu jane saakshi thili
I was a witness.	mu jane saakshi thili
I was at home.	mu ghaare thili
I was at home.	mu ghaare thili
I was at home.	mu ghaare thili
I was at school.	mu schoolre thili
I was at work.	mu kamare thili
I was born here.	mu eithare janma neithili
I was busy.	mu boyasto thile
I was correct.	mu thik thili
I was courteous.	mu sajanyamulaka thili
I was dismissed.	mote barakhasta karajaithila
I was forced to get a paper route at 10 years old.	Mu 10 barsa bayasare eka kaagaz maarg paibaaku badhya heli
I was furious.	mu ragigali
I was good.	mu bholo thile
I was hungry.	mu bhokila thili
I was impressed.	mu prabhabhita hoithili
I was invited.	mote nimantrana karajaithila
I was jealous.	mu ershya karuthili
I was mortified.	mu mrutyabarana kali'
I was not drunk.	mu madyapana kari na thili
I was on a bike.	mu ek bikere thili
I was rude.	mu abhodro byobhar kali
I was sent home.	mote ghaarku pothaigala
I was serious.	mu gambhira thili
I was shaken.	mu thari uthili
i was shy   	Mun laja kruchi
I was sick.	mu bimaar thile
I was skeptical.	mu sandehi thili
I was sleepy.	mu shoyithili
I was so cold.	mu bahuta thanda thili
I was tempted.	mote pralobhita karagala
I was too drunk.	mu atyadhika madyapa thili
I was too shy.	mu bahuta laajua thili
I was very busy.	mu bahuta byasta thili
I was worried.	mu chintit thili
I wasn't afraid.	mu bhayabhita nathili
I wasn't asleep.	mu soi nathili
I wasn't busy.	mu byasta nathili
I wasn't honest.	mu sachota nathili
I wasn't hungry.	mu bholila nathili
I watch the BBC.	mu bbc dekhe
I went aboard.	mu jahajare gali
I went inside.	mu bhitaraku gali
I went there.	mu sethaku gali
I went there.	mu sethaku gali
I went to Paris.	mu paris gali
I went to say the truth	sata kahiba pain jaithili
I went to sleep.	mu soibaku gali
I will fight.	mu yudha karibi
I will go at 10.	mu dasre jibi
I will go at 10.	mu dasre jibi
I will go mad by sitting in the house continously	ghare basi basi pagala haijibi
I will go to school	Mu school ku jibi
i will go.	 Mu jibi
i will go. 	Mu jibi
I will help you.	mu tamaku sahajya kaibi
I will help you.	mu tamaku sahajya kaibi
I will join you.	mu tuma sahita jogadebi
I will learn.	mu sikhibi
I will listen.	mu sunibi
i will live   	Mun rahibi
I will meet you tomorrow. 	Mu tuma sahita kali dekha hebi
I will miss you.	mu tote mane pakeibi
I will miss you.	mu tote mane pakeibi
i will play 	Mu khelibi
i will sing  	Mun gita gaibi
I will try	mu prayatna karuchi
I will warn him.	mu taanku chetabani debi
I will watch it.	mu ehakun dekhini
I will work tomorrow 	Mu kali kama karibi
I wish you luck.	mu aapnaku bhagya kamana karuchi
I wish you'd go.	mu ekcha tume jao
I woke Tom up.	mu tama ku jagrita kali
i woke up  	 Mun sakhale uthili
I woke you up.	mu jadi uthi padhile
i won	mu jitili
i won	mu jitili
I wonder why.	mu kahiki bhabuchi
I won't be late.	mu bilambha karibi nahi
I won't be long.	mu adhika samaya hebi nahi
I won't come.	mu asibi nahi
I won't dance.	mu nachibi nahi
I won't deny it.	mu ehaku aswikara karibi nahi
I won't fail.	mu bifal heba nahi
I won't give in.	mu debi nahi
I won't go.	mu jeebi nahi
I won't laugh.	mu hasibi nahi
I won't leave.	mu jibi nahi
I wont listen to anything	mu aau sunibini
I won't lose!	mu haraibi nahi
I work a lot.	mu bahut kaam kare
I work at a bar.	mu ek barre kama kare
I work in Milan.	mu milanre kama kare
I write poems.	mu kabita lekhe
I wrote it down.	mu ehaku lekhili
I wrote it down.	mu ehaku lekhili
Ice is solid.	baraf drudha atey
I'd do it again.	mu eha pini karibi
I'd like a beer.	mu ek beer chahuchi
I'd like a fork.	mu ek kata chahuchi
I'd like a soda.	mu ek soda chahuchi
I'd like that.	mu taha chahe
I'd like that.	mu taha chahe
I'd like that.	mu taha chahe
I'd like to pay.	mu dei debaku nahhi
"I'd like to tell you about one such child,"	Mu aapnanku aepari eka shishu bisayare kahibaku chahe
I'd rather stay.	mu adhika rakhibaku nahi
ignore it    	ehaku anadekha karantu
Ignore Tom.	tom ku aandekha karnti
I'll allow it.	mu ehaku anumati debi
I'll allow it.	mu ehaku anumati debi
I'll allow this.	mu ehaku anumati debi
I'll allow this.	mu ehaku anumati debi
I'll ask around.	mu chariaade pacharibi
I'll ask him.	mu tanku pacharibi
I'll ask Tom.	mu Tom ku pacharibi
I'll assist Tom.	mu tamaku sahajya karibi
I'll be alone.	mu aekutiya rahibi
I'll be back.	mu pheribi
I'll be back.	mu pheribi
I'll be brief.	mu heba shankshipt hebe
I'll be careful.	mu satarka rahibi
I'll be free.	mu mukta hebi
I'll be glad to.	mu khushi hebi
I'll be glad to.	mu khushi hebi
I'll be nice.	mu bhala hebi
I'll be nice.	mu bhala hebi
I'll be nice.	mu bhala hebi
I'll be on time.	mu thik samayare hebi
I'll be present.	mu upasthitha rahibi
I'll be present.	mu upasthitha rahibi
I'll be there.	mu seithi thibi
I'll buy a Ford.	mu ek ford kinibi
I'll buy that.	mu taha kinibi
I'll buy this.	mu aehaku kinibi
I'll call again.	mu puni phone karibi
I'll call him.	mu tomaku dakibi
I'll call the police	mun pulis dakibi
I'll call you.	mu tamaku dakibi
I'll check it.	mu aehaku jaanch karibi
I'll check that.	mu taha jaancha karibi
I'll come alone.	mu akutiya asibi
I'll do it.	mu taha kareebi
I'll do my best.	mu moro jathasambhaba chesta karibi
I'll do my best.	mu moro jathasambhaba chesta karibi
I'll do that.	mu taha karibi
I'll do that.	mu taha karibi
I'll do that.	mu taha karibi
I'll enjoy this.	mu aehaku upabhoga karibi
I'll enjoy this.	mu aehaku upabhoga karibi
I'll enjoy this.	mu aehaku upabhoga karibi
I'll fix it now.	mu bartamana thik karibi
I'll fix it now.	mu bartamana thik karibi
I'll follow you.	mu tumaku anusarana karibi
I'll get help.	mu shahayata paibi
I'll get my bag.	mu moro bag paibi
I'll go ask Tom.	mu tumaku pachatribaku jibi
I'll go ask Tom.	mu tumaku pachatribaku jibi
I'll go by taxi.	mu taxkire jibi
I'll go by taxi.	mu taxkire jibi
I'll help Tom.	mu tomaku sahajya karibi
I'll help you.	mu tomaku sahajya karibi
I'll help you.	mu tomaku sahajya karibi
I'll join you.	mu toma sahita jogadebi
I'll keep watch.	mu jagi rahibi
I'll kill him.	mu tomaku hatya karibi
I'll kill you.	mu tomaku maribdebii
I'll kill you.	mu tomaku maribdebii
I'll look it up.	mu aehaku dekhibi
I'll look it up.	mu aehaku dekhibi
I'll look it up.	mu aehaku dekhibi
I'll mention it.	mu aehaku ullekha karibi
I'll miss you.	mu tomaku miss karibi
I'll miss you.	mu tomaku miss karibi
I'll order food.	mu khadya order karibi
I'll order food.	mu khadya order karibi
I'll pay for it.	mu aethipai debi
I'll play along.	mu saangare khelibi
I'll play along.	mu saangare khelibi
I'll prove it.	mu ekhaku pranama karibi
I'll show you.	mu tomaku dekhaibi
I'll show you.	mu tomaku dekhaibi
I'll show you.	mu tomaku dekhaibi
I'll sleep here.	mu aethare soibi
I'll start.	mu aarombho karibi
I'll take him.	mu taanku neijibi
I'll take Tom.	mu tom ku nebi
I'll take Tom.	mu tom ku nebi
I'll take Tom.	mu tom ku nebi
I'll tell you.	mu tomaku kahibi
I'll tell you.	mu tomaku kahibi
I'll try that.	mu taha chesta karibi
I'll warn Tom.	mu tamaku chetabani debi
I'll watch it.	mu ehaku dekhibi
I'll watch TV.	mu TV dekhibi
I'll work alone.	mu aekutiya kaam karibi
i'm 19	mora 19 barsa bayasa hei jaichi
i'm 19	mu 19 bayasara
I'm a bit drunk.	mu tikiye madyapana karichi
I'm a bit tipsy.	mu tike tipsy
I'm a bit tired.	mu tike kalanta
I'm a bit tired.	mu tike kalanta
I'm a bit tired.	mu tike kalanta
I'm a carpenter.	mu jane carpenter
I'm a carpenter.	mu jane carpenter
I'm a carpenter.	mu jane carpenter
I'm a chauffeur.	mu jane chauffer
I'm a communist.	mu jane communist
I'm a coward.	mu jane bhiru
I'm a detective.	mu jane guptachara
I'm a doctor.	mu jane Doctor
I'm a friend.	mu jane bandhu
I'm a genius.	mu jane pratibha
I'm a good cook.	mu jane bhala raandhu
I'm a good cook.	mu jane bhala raandhu
I'm a hero.	mu jone hero
I'm a housewife.	mu jane gruhani
i'm a man   	Mun jane purusa loka
I'm a night owl.	mu ek raati pecha
I'm a night owl.	mu ek raati pecha
I'm a night owl.	mu ek raati pecha
I'm a policeman.	mu jane police
I'm a purist.	mu jane shudhabadi
I'm a purist.	mu jane shudhabadi
I'm a redhead.	mu eka redhead
I'm a student.	mu eka chatra
I'm a student.	mu gotiye chatra
I'm a student.	mu jane bidyarthi
I'm a student.	mu jane chatra
I'm a suspect.	mu jane suspect
I'm a teacher.	mu eka teacher
I'm a teacher.	mu jane sikshaka
I'm a tourist.	mu jane paryataka
I'm a TV addict.	mu jane tv jogi
I'm a TV addict.	mu jane tv jogi
I'm able to run.	mu chalaibaku sakhshama ate
I'm able to run.	mu chalaibaku sakhshama ate
I'm able to ski.	mu ski karibaku sakhshama ate
I'm about ready.	mu prastuta achi
I'm addicted.	mu nishasakta atey
I'm addicted.	mu nishasakta atey
I'm adventurous.	mu sahashika ate
I'm adventurous.	mu sahashika ate
I'm afraid so.	mu bhaya karuchi
I'm afraid.	mu bhayabhit aachi
I'm all ears.	mu sabu kaana
I'm all right.	mu thik achi
I'm all right.	mu thik achi
I'm almost done.	mu praya karisarichi
I'm alone now.	mu bartamaan ekaki
I'm always busy.	mu sabubele byasta achi
I'm an addict.	mu jane jyogi
I'm an artist.	mu jane kalakaar
I'm an engineer.	mu jane engineer
I'm an optimist.	mu jane ashawadi
I'm an optimist.	mu jane ashawadi
I'm an orphan.	mu jane anaath
I'm anemic.	mu rakthinn
I'm angry	Mu ragichi
i'm angry   	Mun ragichi
I'm attentive.	mu dhyana deuchi
i'm awake   	Mun uthisarichi
I'm beautiful.	mu sundara
I'm begging you.	muj tamaku bikhsha karuchi
I'm begging you.	muj tamaku bikhsha karuchi
I'm begging you.	muj tamaku bikhsha karuchi
I'm better.	mu bholo thile
i'm bored   	Mun birakta hoisarichi
i'm broke   	Mun bhagipadichi
I'm busy here.	mu ethare byasth achi
I'm busy now.	mu bartamaan byastha achi
I'm busy now.	mu bartamaan byastha achi
I'm Canadian.	mu Canadian
I'm catching on.	mu dharichi
I'm color-blind.	mu raangaandha
I'm color-blind.	mu raangaandha
I'm coming back.	mu pheri asuchi
I'm coming.	mu aasuchi
I'm coming.	mu aasuchi
I'm convinced.	mu nishchit
I'm divorced.	mu chadpatra hoichi
I'm drowning.	mu budi jauchi
I'm drowning.	mu budi jauchi
i'm dying  	 Mun marijauchi
I'm easygoing.	mu sahaja atey
I'm eating.	mu khauchi
I'm eating.	mu khauchi
I'm eating.	mu khauchi
I'm eighteen.	mu 18
I'm eighteen.	mu 18
I'm embarrassed.	mu lajjita
I'm enjoying it.	mu  aehaku upabhoga karuchi
I'm escaping.	mu palayana karuchi
I'm exhausted.	mu klant hoigali
I'm exhausted.	mu thaki gali
I'm expecting.	mu asha karuchi
I'm famous.	mu prosidho
I'm feeling fit.	mu fit anubhava karuchi
I'm feeling sleepy	Mate needa maduchi
I'm fighting.	mu yudha karuchi
I'm fine	Mu bhala acchi
I'm fine	Mu bhala acchi
I'm finished.	mu samapt
I'm flattered.	mu santushta
I'm freezing.	mu freeze karuchi
I'm freezing.	mu freeze karuchi
I'm French.	mu faarsi 
I'm from	Mu asichi
I'm from Brazil.	mu brazil ra
I'm from Canada.	mu canada ra
I'm from Turkey.	mu turkeyru ashuchi
I'm getting hot.	mu garam heuichi
I'm getting old.	mu briddha pauchi
i'm going   	Mun jauchi
I'm going mad.	mu pagal hoijaichi
I'm going to go.	mu jibaku jaunchi
I'm good	Mu badhia achhi
I'm good	Mu bhala achi
I'm good 	Mu bhala achi 
I'm gullible.	mu bishwasjogya
i'm happy   	Mun khusi achi
I'm helping you.	mu tamaku sahajya karuchi
I'm here to win.	mu jitibaku aethare achi
I'm hiding.	mu lucaachi
I'm hiding.	mu lucaachi
"I'm home, Tom."	"mu ghare achi, Tom"
I'm horrible.	mu bhayankar
I'm hungover.	mu shikaar atey
I'm hungover.	mu shikaar atey
I'm hungry!	mu bhokila
I'm hungry.	mu bhokila
I'm hungry.	mu bhokila
I'm important.	mu jaruri
I'm impressed.	mu prabhabit hoichi
I'm in a gang.	mu eka dal re achi
I'm in a jam.	mu eka jam re achi
I'm in bed.	mu bichona re aachi
I'm in Boston.	mu Boston re achi
I'm in danger.	mu bipadare achi
I'm in denial.	mu aswikaar karuchi
I'm in Paris.	mu Paris re achi
I'm in Portugal.	mu potugalre achi
I'm innocent.	mu nirdosh
I'm just lazy.	mu kebala alasua
I'm Korean.	mu korean
I'm leaving now.	mu bartamana jaunchi
I'm left-handed.	mu baamhathi
I'm lonely.	mu aakotiya
I'm losing.	mu hrauchi
I'm losing.	mu hrauchi
I'm losing.	mu hrauchi
I'm lost	mu haji jauchi
I'm miserable.	mu dukhi
I'm motivated.	mu prerit
I'm my own boss.	mu moro nijara malika
I'm nearsighted.	mu doordarshan
I'm nervous now.	mu bartamana dhairjyadina achi
I'm never wrong.	mu kadapi bhul nuhe
I'm new in town.	mu shahare nua
I'm no expert.	mu kaunasi bishesagya nuhe
I'm no expert.	mu kaunasi bishesagya nuhe
I'm no rebel.	mu bidrohi nuhe
I'm no rebel.	mu bidrohi nuhe
I'm no saint.	mu kaunasi sadhu nuhe
I'm no saint.	mu kaunasi sadhu nuhe
I'm not a child.	mu pilla nuhe
I'm not a crook.	mu jane kutumba nuhe
I'm not a spy.	mu guptchara nuhe
I'm not a thief.	mu chora nuhe
I'm not a woman.	mu jane mahila nuhe
I'm not alone.	mu eka nuhe
I'm not angry!	mu ragi nahi
I'm not armed.	mu sashakta nuhe
I'm not ashamed.	mu lajjita nuhe
I'm not busy.	mu byasta nuhe
I'm not certain.	mu kichi nuhe
I'm not crazy.	mu pagala nuhe
I'm not dead.	mu mari nahi
I'm not deaf.	mu badhira nuhe
I'm not done.	mu karinahi
I'm not English.	mu engrazi nuhe
I'm not English.	mu engrazi nuhe
I'm not evil.	mu manda nuhe
I'm not finicky.	mu chauta nuhe
I'm not free.	mu mukta nuhe
I'm not happy.	mu khushi nuhe
I'm not here.	mu ethare nahi
I'm not hurt.	mu aaghat payinahi
I'm not hurt.	mu aaghat payinahi
I'm not interested	mate iccha nahi
I'm not jealous.	mu ershya kare nahi
I'm not kidding.	mu maza kaunahi
I'm not kidding.	mu maza kaunahi
I'm not married.	mu bibahita nuhe
I'm not married.	mu bibahita nuhe
I'm not nervous.	mu mu bibrata nuhe
I'm not obese.	mu mota nuhe
I'm not over it.	mu eha upare nuhe
I'm not ready.	mu prastuta nuhe
I'm not ready.	mu taiyaar nuhe
I'm not rich.	mu dhani nuhe
I'm not sick.	mu asustha nuhe
I'm not so sure.	mu aite nishchita nuhe
I'm not sure.	mu nishchit nuhe
I'm not sure.	mu nishchit nuhe
I'm not tired.	mu thaki nahi
I'm not upset.	mu birakta nuhe
I'm not well.	mu bhala nuhe
I'm not well.	mu bhala nuhe
I'm now unarmed.	mu bartamaana ashtahina
I'm off beer.	mu beer band achi
I'm offended.	mu birakta
i'm okay	mu thik achi
I'm on a diet.	mu eka khadya upare achi
I'm on my own.	mu nije achi
I'm on my way.	baatare achi
I'm on my way.	mu rasta re achi
I'm on the list.	mu talikare achi
I'm on the roof.	mu chhata upare achi
I'm on vacation.	mu chuttire achi
I'm out of here.	mu aithare baharichi
I'm out of here.	mu aithare baharichi
I'm over here.	mu ethare achi
I'm persevering.	mu sthira achi
i'm ready   	Mun prastuta achi
I'm ready to go.	mu jibaku prastuta achi
I'm really fast.	mu prakrutare druta ate
i'm right  	 Mun thik 
I'm ruined.	mu naust hoejaechi
I'm safe here.	mu ethare surakshita achi
I'm satisfied.	mu santushta
I'm scared.	motw daar laaguchi
I'm screaming.	mu chitkaar karuchi
I'm searching of this place	mu ehi jagatiku khojuchi
I'm shooting.	mu shooting karuchi
I'm sick	mun asustha achi
I'm sleeping.	mu soyichi
I'm sleepy!	moote neendo laaguchi
I'm so fat.	mu bohut moota
I'm so fat.	mu bohut moota
I'm so happy.	mu bahut khusi
I'm so sorry.	mu bahut dukhi
I'm so sorry.	mu bahut dukhi
I'm so sorry.	mu bahut dukhi
I'm so tired!	mu bahut thakijaichi
I'm sorry	mun duhkhita
i'm sorry    	Mate khyama kribe
I'm speaking.	mu kahuchi
I'm standing.	mu thia hoyichi
I'm starving!	mu bhokare achi
I'm starving!	mu bhokare achi
I'm starving!	mu bhokare achi
I'm starving!	mu bhokare achi
I'm starving.	mu bhokare achi
I'm the best.	mu sarbottam
i'm tired    	Mun thaki jaichi
I'm Tom's dad.	mu Tomanka bappa
I'm Tom's mom.	mu Tom ra maa
I'm Tom's niece.	mu tamaku bhaja
I'm Tom's uncle.	mu tamaku mamu
I'm uninsured.	mu bimabhukta nuhe
I'm uninsured.	mu bimabhukta nuhe
i'm upset    	Mun dukhi achi 
i'm upset    	Mun dukhi achi 
I'm upstairs.	mu upar mahalare achi
I'm very busy.	mu bahut byastha achi
I'm very cold.	mu ati thanda achi
I'm very fat.	mu bahut mota
I'm very lazy.	mu bahut alasua
I'm very sad.	mu bahut dukhi
I'm very shy.	mu bahut lajua
I'm worn out.	mu klant hoigali
I'm your boss.	mu tumara boss
in between	majhii re
In Burma and Ceylon she intends to hold on as long as she can .	Burma eban Ceylon re se jete din parjyanta dhari rakhibaku iccha karanti
IN farsi philosophy firdaus garden is presented as ideal one in Mugal literatures.	Farsi darshan firdaus bagichare Mughal sahityare aadarsh bhabare upasthapit heuchi
"In order to cook, you need fire and water"	Rosei karibaku nia o panir abasyaka hue
In the morning	Sokaley
"in these the main are farakka dam,tihari dam,and bheemghoda dam"	Egudikare mukhya heuchi farakka Dam tihari Dam eban Bhimgoda Dam
In this lies the circumstances of people before you.	Ethire aapnanka aagare thiba lokanka abastha achi
"In this positive connotation , liberty would mean freedom of the individual to do what one likes ."	Taanku bhetiba paayi se onek samyare nijara bahut ichcha bisayare aama sahit katha heuthile
In which branch u r studying? 	Tume kau branch re padhucha 
India is a great country.	Bharat gotiee mahan Desha atte.
insipid	swaduhina
Iron is hard.	loha kathin
is 	ate
Is breakfast/supper included?	ethire jalakhia/ratri bhojana madhya asuchi ki?
Is he at home?	se ghare achanti ki?
Is he correct?	se sathik atey ki?
Is he dead?	se moorichonti ke
Is he looking?	se dekhuchanti ki?
Is he tall?	se lomba ki
Is it a deer?	eha eka hirana ki?
is it bad?   	eha kn kharap
is it far?   	eha kn dura
Is it free?	aeha maagona ki?
Is it love?	 aeha premo ki
Is it my turn?	eha mora pali?
Is it my turn?	eha more turn?
is it new?   	eta kn nua
Is it popular?	eha lokpriya ki?
Is it serious?	eha gambhir ki?
Is it too big?	eha bahut bada ki?
Is it too big?	eha bahut lamba ki?
Is it working?	eha kaam karuchi ki?
Is that a bat?	eha eka bat ki?
Is that a cat?	seita billi ki?
Is that a lot?	taha bahut ki?
Is that a wig?	taha eka wig ki?
Is that it?	taha ki
Is that sweet?	taha mitha ki?
Is that true?	eha sata ki?
Is that yours?	taha tumara ki?
Is there someone here who speaks English	eithi kehi engraji kohi paronti
Is this it?	aeha ki
Is this Latin?	eha Latin ki?
Is this legal?	eha aainagata ki?
Is this legal?	eha legal ki?
Is this love?	eha ki prema?
Is this love?	iye kana prema?
Is this Tom's?	eha Tom kara ki?
Is this yours?	eha tumara achi ki?
Is this yours?	eha tumara ki?
Is this yours?	eha tumara ki?
"is to create ownership in the community to the problem,"	Samasya paayi sampradayare malikana shrusti kariba heuchi
Is Tom alone?	Tom ekaki ki?
Is Tom around?	Tom pakhare achi ki?
Is Tom coming?	Tom asuchi ki?
Is Tom drunk?	Tom madyapa ki?
Is Tom hungry?	Tom bhokila achi ki?
Is Tom hungry?	Tom hungry ki?
Is Tom ill?	tom aaswasth ki
is Tom in?  	Kn Tom bhitare achi?
Is Tom nearby?	Tom pakhare achi ki?
Is Tom ready?	Tom prastuta ki?
Is Tom stupid?	Tom murkha ki?
Is Tom there?	Tom sethare achanti ki?
"Islam is the world's second-largest religion, after Christianity."	Christian dharma pare Islam heyuchi bishwara dwitiya brihattam dharma
Isn't it cool?	eha shaant nahi ki?
Isn't it flat?	eha samtal nuhe ki?
Isn't it true?	eha sata nueh ki?
it	eita
It came apart.	eha alga hoigala
It came apart.	eha alga hoigala
It did happen.	eha ghatila
it doesn∆t feel good	kichi bhala laguni
It had snowed.	tusharpaat hoithila
It happens.	aeha hu aee ?
It has three small domes and has been constructed using white marble.	Ehara teenoti chota gomukha achi ebam dhala marbel vyabahaar kari nirmaan karajaichi
it helps. 	Eita kama kare
It hurts here.	eha ethare dard hue
It hurts here.	eha ethare jantana diye
It is 7:45.	aeha 7:45 aate 
It is a curse.	eha eka abhishap
it is hot. 	Eita garam achi
it is me. 	Eita mu
it is me. 	Eita mu
it is new. 	Eita nua
It is no joke.	eha kaunasi hasyaspada nuhe
It is no joke.	eha kaunasi joke nuhe
It is pitch dark.	eha pitch andhara
It is pitch dark.	eha pitch andhara
It is pitch dark.	eha pitch andhara
It is raining outside. 	Bahare barsa heuchi
It is raining.	barsa heuchi
It is snowing.	tusharpaat heuchi
It is too hot.	eha atyadhik garam atey
It is very small.	eha bahut chota atey
It isn't easy.	eha sahaj nuhe
It isn't mine.	eha mora nuhe
It isn't mine.	eha morea nuhe
It isn't obvious.	eha spashta nuhe
It isn't obvious.	eha spashta nuhe
It isn't true.	eha satya nuhe
It looks good.	eha bhala dekha jauchi
It looks so real.	eha ete bastaba dekha jauchi
It makes me sick.	eha mote asustha kare
It matters to me.	eha mo payi gurutwapurna
It matters to me.	eha mo payi gurutwapurna
It matters to us.	eha aama payi gurutwapurna
It matters to us.	eha mo payi gurutwapurna
It might rain.	barsa heipare
It needs washing.	eha dhoiba abashyaka kare
It needs washing.	eha dhoiba abashyaka kare
It needs washing.	eha dhoiba abashyaka kare
It never existed.	eha kebe bidyaman nathila
It seemed normal.	eha swabhabik mane heuthila
It seems strange.	eha ajab lagichi
It should be fun.	eha maja hena uchit
It sickens me.	eha mote asustha kare
It smells bad.	eha kharab gandha atey
It smells bad.	eha kharab gandha atey
It sounds simple.	eha saral laguchi
It takes time.	eha samaya neithaye
It was a gift.	eha eka upahaara thila
It was a hot day.	garam dina thila
It was a joke.	eha eka parihaasa thila
It was a mistake.	eha eka bhul thila
It was a trap.	eha eka jaal thila
It was chilly.	eha thanda thila
It was good news.	eha eka khusi khabar thila
It was his fault.	eha taankara dosh thila
It was his fault.	eha taankara dosh thila
It was simple.	eha sarala thila
It was so simple.	eha bahut saral thila
It was stupid.	eha murkha thila
It was superb.	eha atyanta sundar thila
It was the truth.	eha satya thila
It was urgent.	eha abashyaka thila
It was urgent.	eha jaruri thila
It was very cold.	bahut thanda thila
It was very hard.	eha bahut kathin thila
It was very hard.	eha bahut kathin thila
It was very ugly.	eha atyant ashubh thila
It was your idea.	eha tumara dharana thila
It was your idea.	eha tumara dharana thila
It was your idea.	eha tumara dharana thila
It wasn't enough.	eha jatestha nuhe
It won't be easy.	eha sahaj heba nahi
It won't be easy.	eha sahaja heba nahi
It won't be long.	eha adhik samaya heba nahi
it wont happen again	aau habani
It won't hurt.	ethire kaunasi asubidha heba nahi
It won't hurt.	ethire kaunasi asubidha heba nahi
It won't work.	eha kaam kariba nahi
It worked .	Eha kaam kala
it worked.  	eha kama kruchi
It works well.	eha bhala kaam kare
It works well.	eha bhala kaam kare
it would have been better like that	semiti thile bhala haithanta
It wouldn't hurt.	ethire kaunasi asubidha heba nahi
It'll snow today.	aji tusharpat heba
it's 3:30   	Ebe 3:30 hoichi
it's 7:45   	Ebe 7:45 hoichi
It's 8:00 p.m.	eha rati 8
it's 9:15	Ebe 9:15 hoichi
It's a bad habit.	eha eka kharap abhyas
It's a bet.	aeha ek baaaji
It's a big world.	eha eka bada duniya
It's a big world.	eha eka bada duniya
It's a done deal.	eha eka samapta deal
It's a fad.	aaeha ek faayad
It's a fad.	aaeha ek faayad
It's a full moon.	eha eka purnachandra
It's a good book.	eha eka bhala pustak
It's a good deal.	eha eka bhala deal
It's a good plan.	eha eka bhala yojana
It's a good rule.	eha eka bhala niyamanusaar
It's a mad world.	eha eka pagal duniya
It's a relief.	eha eka aaramdayaka
It's a secret.	eha eka rahasya
It's a sunflower.	eha eka surjyamukhi
It's a sunny day.	eha eka kharadina
it's a TV    	Eha tv
It's a windy day.	eha eka paban dina
It's accurate.	eha sathik
It's alive.	aaeha jeebont aate
It's all mine.	eha sabu mora
It's all over.	eha samapta hoi gala
It's all over.	eha samapta hoi jaichi
It's all over.	eha samapta hoichi
It's all over.	eha samapta hoijaichi
It's almost dark.	praya andhaara
It's almost over.	eha praya samapt hoichi
It's almost time.	eha praya samaya
It's an emergency	eha eka apadkalina paristhiti
It's an illusion.	eha eka bhram
It's an order.	eha eka aadesh
It's annoying.	eha annoying achi
It's bad for you.	eha aapananka payi kharap arey
It's balmy today.	aji eha balmy
It's become dark.	andhar hoigala
It's been fun.	eha maja hoichi
It's bitter cold.	eha tikta thanda
It's bulky.	aaeha bohut bodo oate
It's bulky.	aaeha bohut bodo oate
It's business.	eha byabasaya
It's clear.	aaeha sposto hoechi
It's close by.	eha pakhapakhi
It's close by.	eha pakhapakhi achi
it's cold    	Eha thanda
It's cold there in december	Ethare disembar masare thanda huee
It's comfortable.	eha aramdayak
It's comfortable.	eha aramdayak
It's complicated.	eha jatil
It's conceivable.	eha kalpana jogya
it's cool    	Eha thanda
it's dark    	Ethare andhar achi
It's early.	aaeha seeghro oete
It's exciting.	eha utsahajanak
It's fall now.	eha bartamaan paduchi
it's free    	Eha bina mulyare
its good for them	tankara bhala
It's gorgeous.	eha sundar atey
It's green.	aaeha soobujo
it's hard    	Eha bohut kasta
It's hopeless.	eha ashabadi
It's hot in march	Ethare  marc masare garam huee
It's inhumane.	eha amanbiya
it's late     	Ebe deri hoijaichi
It's midnight.	eha madhyaratri
it's mine     	Eta moro
It's my CD.	aaeha mooro CD 
It's my fault.	eha mora dosh
It's my horse.	eha mo ghoda
It's my horse.	eha mora ghoda
It's my treat.	eha mora chikitsa
It's my treat.	eha mora chikitsa
It's night.	raati hoegolani
It's not cold.	eha thanda nuhe
It's not easy.	eha sahaja nuhe
It's not fair.	eha thik nuhe
It's not here.	eha aetare bahi
It's not mine.	eha moro nahi
It's not true.	eha satya nuhe
It's obsolete.	eha puruna ate
It's on me.	aaeha mo bhopre aachi
it's open     	Ebe khola achi 
it's ours    	 Eta amara
It's possible.	eha sambhaba
its rold gold	kinaa ta
It's so sweet.	eha bahuta mitha
It's the cops!	eha police
It's Tom's voice.	eha Tom ra swara
It's Tom's.	aeha tom ro
It's too cold.	eha atyadhika thanda
It's too dark.	eha atyanta andhakaaar
It's too easy.	eha bahuta sahaj ate
It's too easy.	eha bahuta sahaj ate
It's too fast.	eha bahuta fast ate
It's too hard.	eha bahuta kathina
It's too hard.	eha bahuta kathina
It's too late.	bahuta deri heigala
It's too loud.	eha bahuta jorare
It's too soon.	eha bahuta shigraha
It's too thin.	eha bahut patala
It's too thin.	eha bahuta patala
It's too ugly.	eha atyanta asubha ate
It's too ugly.	eha atyanta sasubha ate
it's true     	Eha satya 
It's unlikely.	eha sambaba nuhe
It's unlocked.	eha unlock hoichi
It's unlocked.	eha unlock hoichi
It's upstairs.	eha upare mahalare
It's white.	aaeha dhodha
It's windy.	aehaa pawano aute
it's work    	Eha kama
I've been injured	moro chot laguchi
I've eaten.	mu khechi
I've found it.	mu eha paichi
I've got more.	mu adhika paichi
I've returned.	mu pheri asichi
I've seen Tom.	mu Tom ku dekhi thili
I've seen Tom.	mu Tom ku dekhichi
I've seen Tom.	mu Tom ku dekhichi
I've tried.	mu chaesta karichi
jeweller	sunari
juice	rasala
jump down   	Talaku deinba
Just a minute.	kebala gotiye minute
"Just be there, i will be right back"	"Bas sethi thao, mu sange sang pheruchi"
Just check it.	eha jaancha karantu
Just check it.	ehaku jaancha karantu
Just check it.	ehaku jaancha karantu
Just check it.	ehaku jaancha karantu
Just check it.	ehaku jaancha karantu
Just do it.	kebode taha koro
Just relax.	kebode aaramo karo
keep away   	Durare rakha
keep back   	Pachaku ruha
keep cool    	Thanda rakha
Keep doing the deeds without any expectations for results	Karma kari chala bina phala prapti asa re
Keep in touch!	samparkare ruhantu
Keep in touch.	samparkare ruhantu
Keep it quiet.	ehaku chup kara
Keep it quiet.	ehaku chup kara
Keep it quiet.	ehaku chup kara
Keep it up!	jaari rakho
Keep it up.	jaari rakho
Keep paddling.	padding rakhantu
Keep paddling.	padding rakhantu
Keep quiet.	shanti ruha 
keep that    	Seta rakhidia
keep them   	sesabu rakhidia
Keep Tom busy.	tom ku byasta rakhantu
Keep Tom busy.	tom ku byasta rakhantu
keep warm   	Usum rakha
kiss me 	Chumma diya
kiss me 	Chumma diya
kiss Tom.	 Tom ku
last week	purba sptaha
later	pare
Leave	Chade
leave	chade 
leave me alone	mate ekutia chadi dia.
leave me alone	mate ekutia chadi diyantu
Leave me alone.	Mate ekutia chadi dia.
leave now    	Ebe tume jaipara
Leave Tom   	Tom ku chadidia
Leave town.	sohoro chadidiyo
leave us.	 Aama ku chada
Let go of Tom.	tom ku chadidiya
Let him do it.	tanku taha karibaku diyantu
Let him do it.	tanku taha karibaku diyantu
Let him do it.	tanku taha karibaku diyantu
Let him enter.	tanku prabesa kara
let it be    	 Seta Hebaku dia
Let me die.	moote moribaku dio
let me go.   	Mate jibaku dia
let me in    	Mate bhitaraky chada
Let me out!	moote baharuku diyo
Let me pay.	moote pay deyonti
Let me pay.	moote pay deyonti
Let me see.	moote dekhibaaku diyanti
Let me see.	moote dekhibaaku diyanti
Let me see.	moote dekhibaaku diyanti
Let me see.	moote dekhibaaku diyanti
Let me try it.	mote ehaku chesta karibaku dia
Let me try.	moote chesta kaarebaku diyo
Let me try.	moote chesta kaarebaku diyo
Let them talk.	semananku katha hebaku diyantu
Let Tom do it.	tom ehaku karibaku dia
Let Tom do it.	tom ehaku karibaku dia
Let Tom speak.	tom katha hebaku dia
let us go. 	Chala jiba
Let us out.	chhalo baharku jeeba
Let us out.	chhalo baharku jeeba
Let's ask him.	chala tanku pachariba
Let's ask him.	chala tanku pachariba
"Let's celebrate together, eat sweets and crack fireworks"	Aji dipaoli abasarare ekathi misi mitha khaiba oban phutaiba
Let's eat out.	chala khaiba
Let's eat out.	chala khaiba
Let's eat together	cala ame miski khaiba
lets go	chale hele
Let's go and buy something for market	cala ekathi market ru kichi kiniba
Let's go away.	chala jiba
Let's go back.	chala pherijiba
Let's go home.	chala gharaku jiba
Let's go to classes. 	Chala class jiba. 
Let's go to play	Chala kheli jiba
Let's go to temple together	cala ame ekathi mandira yiba
Let's go.	Chalo jeeba.
Let's keep it.	chala ehaku rakhiba
Let's open it.	chala ehaku kholiba
Let's pray.	chalo prarthona kareeba
Let's proceed.	chalantu chaliba
Let's sue Tom.	chala tomanku birudhare abhijoga kariba
Let's talk.	chlonti kautha haeba
let's try    	Dekhe chesta kriki
Life is crazy.	jibana pagala
Life is full of ups and down but still beautiful	Jibanare tike upar tala rahe taha hele madhya jiban sundar ate
Life is short.	jibana jhudra ate
Life is tough.	jibana kathina ate
Life's unfair.	jibanara anyaya
Listen to Tom.	tom suna
Live your life to the fullest	Nija jibana ku sampurna rupa re banchiba uchita
lock it. 	Tala maro
lock it. 	Tala maro
Lock the door!	kabata bandh kara
Lock the door!	kabata bandh kara
Lock the door.	kabata bandh kara
long time no see	Bahut din helani dekha nahi
Look again.	punarbar dekho
Look ahead.	aagoku dekho
Look ahead.	aagoku dekho
Look ahead.	aagoku dekho
Look ahead.	aagoku dekho
Look at me.	moote dekho
look back   	Pachaku dekha
look back   	Pachaku dekha
Look down.	Talaku dekho.
Look it up.	aaehaku dekho
Look out!	Dekha!
look out. 	Dekha tike
Look there.	seethare dekho
loosen it   	 Dhila kara
loosen it    	Dhila kara
loosen up. 	 Dhila kara
loosen up.  	Dhila kara
Love hurts.	premo kasto diyye
Love is blind.	prema andha ate
Love is blind.	prema andha ate
Love lasts.	premo chalithaye
Mad	Pagad
MahanT is useless	MahanT is gadha
Maine	Mu
Make your bed.	tumara bichana tiyaari kara
Mama cried.	mama kaandhila
Man is mortal.	manisha martya ate
Mango	Aamba
"Many countries in the [unclear], they need legitimacy."	Aspasht ra onek desha semanankara legitimacy abashyaka
"Many countries in the [unclear], they need legitimacy."	Aspasht ra onek desha semanankara legitimacy abashyaka
Many dreams in my eyes	Many dreams in my eyes
many people have died in that place	se jagah re bahut loko marijaichanti
marry me. 	Baha hua mote
Mary is a fox.	marium eka thekua
Mary is weird.	mariyam bhichitra ate
Mary is weird.	mariyam bhichitra ate
Mary shrieked.	mariyam bhichitra ate
Masterbation	Masturbation
May I ask why?	mu kahiki pacharibi?
May I ask why?	mu kahiki pacharibi?
May I come in?	mu bhitaraku aasipare ki?
May I come in?	mu bhitaraku aasipare ki?
May I come in?	mu bhitaraku aasipare ki?
May I go home?	mu gharaku jai paribi ki?
may i go. 	Mu jai paribi ki ?
may I see the room first?	mu prathame kakhya dekhi pare ki?
Meat's scarce.	masara abhaba
men	purusha
Men never cry.	purushamane kadapi kadhanti nahi
midnight	madhyaratri
milkman	gauda
mine its free	moro khali thauchi
minute	muhurta
Mom's working.	mu kama karuchi
monday	somabar
Monkey	Mankada
month	maasah
more laughter	mote lauchig
morning	sakala
Mother	Ma
Motherfucker	Magia
mouth	paati
move overs  	gaku jaipara
move overs  	gaku jaipara
my	moro 
My back hurts.	mora pithi jantana heuchi
My back hurts.	mora pithi jantana heuchi
My back hurts.	mora pithi jantana heuchi
My back hurts.	mora pithi jantana heuchi
My car is red.	mo car lal
My dog ate it.	mora kukura ehaku khaila
My dog is big.	mora kukura bada
My eyes are really hurting today.	Mo akhi re aji bhari kasta heu achi.
My foot hurts.	mora pada jantana diye
My foot hurts.	mora pada jantana diye
My foot hurts.	mora pada jantana diye
My head aches.	mora munda bindhuchi
My head aches.	mora munda bindhuchi
my hovercraft is full of eels	mo hobarkrapht re il bharti hei jaichi
My knee hurts.	mo athathare jantana heuchi
My name is	Mora nama
My name is Nidhi Agarwal	Mo naa Nidhi Agarwal
My name is Rishika 	Mo naam Rishika achi 
My name is sachin	Mora naam sachin
My name is Soham	Mo naa Soham
My name is Virat	Mo naa Virat
My name is XYZ	mor na XYZ oche
My name's Tom.	mora naama tom
My neck hurts.	mora beka jantana karuchi
My neck hurts.	mora beka jantana karuchi
My pen is new.	mora kalama nua ate
My vehicle broke down. 	Mo gadi kharap heigala 
Name	Naa
Naren had three or four meetings with the Consul but found that he was making no progress .	"Aaji jeumane ehi pataka tale thiya heichanti semane heuchanti Bharatiya, Hindu nuhanti, musalmaan nuhanti, baran Bhartiya"
national	rashtriya
Naughty	Bodmash
need to buy a dress now	dress kinibara achi ebe
Never mind!	kebe chinta koro nahi
next week	pra saptaha
nice shot   	bhala mada
nice shot   	bhala mada
Nice to meet you.	Tuma sahita sakhyata kari bhala lagila.
Night	Raati
night	raati
night 	rati
No	Nahi
No comment.	montbyo nahi
No kidding?	mooja nuhe ?
No kidding?	mooja nuhe ?
No kidding?	mooja nuhe ?
No kidding?	mooja nuhe ?
No need	Darkar nahi
no need to bring anything	kichi anibaku darkar nahi
no need to go	jibaku darkar nahi
No problem!	kiichi aasubidha naahi
No problem.	kiichi aasubidha naahi
No problem.	kiichi aasubidha naahi
no way	kebe nuhe
no way	kebe nuhe
no ways	kaunasi upaya nahi
no ways	kaunasi upaya nahi
noon	madhyahna
north	uttara
"Not only that,"	Kebala setiki nuhe
now	ebe
Odia language is the best.	Odia bhasa hauchi sabu tharu uttama
of course   	Nichinta rupe
of course   	Nichinta rupe
Of these Lahadi is a popular one .	Ethi madhyaru Lahadi eka lokopriya atey
"Oh, really?"	"oh, prokrutre"
oilman	teli
ok	hau
"Okay, I'll take it."	"thik achhi, mu ehaku nebi"
okayy then(in a sarcastic manner)	helaa aaau
one language is never enough	mitra gote bhasa jothesta nuhe
One o'clock AM	rati gote
one o'clock PM	aparahna gote
"one ticket to odisha, please"	gote ticket odisha ku diantu
one type of happiness	khussi gote
open	khola
open	khola
opened	kholila
orange 	kamala
over	sarila
painter	chitrakara
Parliament time frame is 5 years and this will be dissolved before that.	Sansadara samay sima paancha barsa ebam eha purbaru eha bilop heba
parliaments control on financial health.	Arthik swaasthya upare sansad niyantran kare
pass	utirna
peel	chopa
pen	kalama
perfect. 	Sampurna thk
perfect. 	Sampurna thk
Perhaps there are problems that you do n't know about .	Bodhhue epari kichi samasya achi jaha bishayare aapana jaananti naahi
"permanent, billowing, voluptuous forms"	Sthayi bileyi voluptuous form
Pick it up.	aehaku uthaao
Playboy	Nalua
please clean my room.	dayakari mo kakhya safa karidiantu
Please clean my room.	Dayakari mo kakhya safa karidiantu.
Please Don't angry	Dayakari ragantu nahi
please don't shout	Dayakari pati karantu nahi
Please ensure that you use the appropriate form 	Dayakari nishchit karantu je aapana upyukt form byabahaara karuchanti
Please fold your hands	Dayakari hara bhangantu
please give me hundred rupees	dayakari she tanka diantu
please go   	daya kri jaipara
please go   	daya kri jaipara
please say that again	dayakari authare kuhantu
please speak more slowly	dayakari tikie aste kuhantu
Please try to understand what I'm trying to say	"Dayakari bhuhibaku cesta karantu, mu yaha kahuci"
please write it down	dayakari lekhi diyantu
Pleased to meet you	apananku bheti bhala lagila
Police!	pullis!
politicians do not have permission to do what needs to be done.	Jaha kariba abashyaka taha karibaku raajnetaanka anumati naah
postcard	chithi
potter	kumbhara
pour	pakaide
"prior to 14th century,country's maximum area got captured in single state"	Chaturdasha shatabdi purbaru sarbadhik anchala eka rajyare kabja kara jayithila
pull	band karantu
Pull me up.	moote taano
Pull me up.	moote taano
pungent	raga
purple	baigani
push	khulantu
put it on   	ethare rakhidia
put it on   	ethare rakhidia
Put the clothes to dry	Kapada sukhei diya
Quiet down.	saanto huo
Quiet down.	saanto huo
Quiet down.	saanto huo
Quiet down.	saanto huo
Quiet down.	saanto huo
Quiet down.	saanto huo
rahul died	rahul mari gala
rahul has slept	rahul soipadichi
rahul is dancing	rahul nachuchi
rahul is singing	rahul gauchi
rahul said me	rahul kahila mate
Ram is a good Boy.	Ram gote bhala pila aate.
Ravi plays football	Ravi football khele
raw	kancha
read this   	ehaku padha
read this   	ehaku padha
really	prakrutare
really	sacchi
recluse	sannyasi
red	laal
red	naali
rice	bhato
ripe	pachila
rotten	pacha
run	daudiba
Run for it!	aaeha paaye doudo
Run!	chala!
said me no	mate mana karile
salty	luni
saturday	sanibar
save Tom. 	Tom ku banchaya
"say ""aah""   "	"kuha ""ahhhaaa"" "
"say ""aah""   "	"kuha ""ahhhaaa"" "
Say cheese.	paneer kuho
Say cheese.	say cheese
Say please.	doyakori kuhonti
Say please.	doyakori kuhonti
say something	kaha kichi
see below  	 talaku dekha
see below   	talaku dekha
seriously.  	satare
seriously.  	satare
she	say
she came by bus yesterday	say kali bus re asila
she came. 	Siye aasila
she cried.  	se kandila
she cried.  	se kandila
She is old.	se bhrudha
she lied. 	Siye micha ka
She likes him.	Siye taaku pasand karanti
She likes him.	Siye taaku pasand karanti
She likes him.	Siye taaku pasand karanti
She likes him.	Siye taaku pasand karanti
She looks sad.	Siye dukhi dekha jaaye
She looks sad.	Siye dukhi dekha jaaye
She loves him.	Siye taaku bhala paaye
She loves him.	Siye taaku bhala paaye
She loves Tom.	Siye tom ku bhala paaye
She loves Tom.	Siye tom ku bhala paaye
She needs you.	Siye tumaku darker kare
She needs you.	Siye tumaku darker kare
She needs you.	Siye tumaku darker kare
She needs you.	Siye tumaku darker kare
She obeys him.	Siye tahanku manati.
She obeys him.	Siye tahanku manati.
She obeys him.	Siye tahanku manati.
She obeys him.	Siye tahanku manati.
She overslept.	Siye overslept.
She overslept.	Siye overslept.
She smiled.	se hoosela
She smiled.	se hoosela
"she thought,'why should my father sit down at floor'"	se je baba kahinki tale basibe bhabila
She wants him.	Siye taaku chahanti
She wants him.	Siye taaku chahanti
She was brave.	Siye sahasi thile.
She was brave.	Siye sahasi thile.
She was livid.	Siye ujwala thile.
She was livid.	Siye ujwala thile.
She was livid.	Siye ujwala thile.
She was livid.	Siye ujwala thile.
She was naive.	Siye nirbodh thile.
She was naive.	Siye nirbodh thile.
She was naive.	Siye nirbodh thile.
She was naive.	Siye nirbodh thile.
She was naive.	Siye nirbodh thile.
She was naive.	Siye nirbodh thile.
She was naive.	Siye nirbodh thile.
She was naive.	Siye nirbodh thile.
She was young.	Siye chota thile.
She was young.	Siye chota thile.
She went home.	Siye gharaku gala.
She went home.	Siye gharaku gala.
She went home.	Siye gharaku gala.
She went home.	Siye gharaku gala.
She's a cutie.	Siye jane kati.
She's a cutie.	Siye jane kati.
She's a cutie.	Siye jane kati.
She's a cutie.	Siye jane kati.
She's busy.	se boyast aachonti
She's dieting.	Siye dieting karuchanti.
She's dieting.	Siye dieting karuchanti.
She's dieting.	Siye dieting karuchanti.
She's dieting.	Siye dieting karuchanti.
She's my type.	Siye mora prakar.
She's my type.	Siye mora prakar.
She's my wife.	Siye mora stree.
She's my wife.	Siye mora stree.
shoemaker	chamara
should I send	pathaibi ki
Show it to me.	Ehaku mate dekhantu.
Show it to me.	Ehaku mate dekhantu.
Show it to us.	Ehaku aamaku dekhantu.
Show it to us.	Ehaku aamaku dekhantu.
Show it to us.	Ehaku aamaku dekhantu.
Show it to us.	Ehaku aamaku dekhantu.
Show it to us.	Ehaku aamaku dekhantu.
Show it to us.	Ehaku aamaku dekhantu.
show me.	 Dekhaya mote
show me. 	Dekhaya mote
Show yourself.	Nijaku dekhantu.
Show yourself.	Nijaku dekhantu.
Show yourself.	Nijaku dekhantu.
Show yourself.	Nijaku dekhantu.
Shut the book.	Bahi band karantu.
Shut the book.	Bahi band karantu.
Shut the door.	Kabat band kara.
Shut the door.	Kabat band kara.
Shut the door.	Kabat band kara.
Shut the door.	Kabat band kara.
shut up 	Muha ta bandh kara
shut up 	Muha ta bandh kara
sign here.  	ethare dastakata kara
sign here.  	ethare dastakata kara
sign this   	dastakata kara
sign this   	dastakata kara
since morning	sakhala thu 
Sing along.	saangore gaao
sit	basiba
sit still    	sudha basa
sit still    	sudha basa
sit ups	bassee
sit ups	uth bass
sky	aakasho
slang	magyaa
Sleep	Soiba
sleep	soipade
Smell this.	aaehaku gondh karonti
smile 	hasa
snake-charmer	kela
snoring	ghugudi
so far	ete durra 
So I want to share with you a couple key insights	Tenu mu tuma sahita duiti mukhya antarnihit anshidaar karibaku chahuchi
so long.	 Ete Lamba
so long. 	Ete Lamba
So there is some sort of justice	Tenu sethare eka prakara nyaya achi
So we light our buildings with daylight.	Tenu aame Dipawali sahita aamara attalikaku alokit karu
Some fish fly.	Kichi maachha udanti.
Some fish fly.	Kichi maachha udanti.
Some may want to get every word exactly right while other children will race to the end of a story .	Keteka huet pratyek shabdaku thik bhabare paibaku chahiparanti jetebele anya pilamane eek kahashira shesh hebaku race kre
Something else	Aau kichi
something something	kichi kichi 
something's going on with him/her	taaro kan chalichi
somewhat irritating	tike bijar
sonali laughs at her own jokes	sonali ta nija joke upare hasse
sour	khata
south	dakhina
Speak clearly.	Spasta bhabare kuhantu.
Speak clearly.	Spasta bhabare kuhantu.
Speak quietly.	Chup chap kuhantu.
Speak quietly.	Chup chap kuhantu.
stale	basi
Stand at ease!	Aaram re thia hua.
Stand at ease!	Aaram re thia hua.
Start here.	aaethare aarambh karonti
Start here.	aaethare aarambh karonti
Start here.	aaethare aarambh karonti
Start here.	aaethare aarambh karonti
start now.   	ebe arambha kara
start now.   	ebe arambha kara
Start over.	puurno aarombh koro
Start over.	puurno aarombh koro
Start running.	Chaliba aarambh karantu.
Start running.	Chaliba aarambh karantu.
Start running.	Chaliba aarambh karantu.
Start running.	Chaliba aarambh karantu.
Start running.	Chaliba aarambh karantu.
Start running.	Chaliba aarambh karantu.
Start running.	Chaliba aarambh karantu.
Start running.	Chaliba aarambh karantu.
Start running.	Chaliba aarambh karantu.
Start running.	Chaliba aarambh karantu.
Start the car.	Car aarambh karantu.
Start the car.	Car aarambh karantu.
Start the car.	Car aarambh karantu.
Start the car.	Car aarambh karantu.
Start writing.	Lekhiba aarambha karantu.
Start writing.	Lekhiba aarambha karantu.
stay back.   	pachaku ruha
stay back.   	pachaku ruha
stay calm   	 santa  ruha
stay calm    	santa  ruha
stay cool    	santa  ruha
stay cool    	santa  ruha
stay down    	santa  ruha
stay down    	santa  ruha
Stay happy	Khusi ruha
Stay in there.	Sethare ruhantu.
Stay in there.	Sethare ruhantu.
Stay positive.	Sakartmak ruhantu.
Stay positive.	Sakartmak ruhantu.
Stay sharp.	teekshno ruho
stay thin    	 patala ruha
stay thin     	patala ruha
Stay together.	Ekathi Ruhantu.
Stay together.	Ekathi Ruhantu.
Stay together.	Ekathi Ruhantu.
Stay together.	Ekathi Ruhantu.
Stay with Tom.	Tom sahita ruha.
Stay with Tom.	Tom sahita ruha.
Stay with Tom.	Tom sahita ruha.
Stay with Tom.	Tom sahita ruha.
Step aside.	gotiye pote paad diyanti
Step aside.	gotiye pote paad diyanti
step back     	pachaku ruha
step back     	pachaku ruha
Step on it!	aaeha bhopre paado diyo
Step on it!	aaeha bhopre paado diyo
Stir the soup.	Chopaku golantu.
Stir the soup.	Chopaku golantu.
stone cutter	pathuria
Stop dreaming.	Sapna dekhiba band kara.
Stop dreaming.	Sapna dekhiba band kara.
Stop fighting!	Yudha band kar.
Stop fighting!	Yudha band kar.
Stop meddling.	Meddley band kar.
Stop meddling.	Meddley band kar.
Stop shooting.	Shooting band karantu.
Stop shooting.	Shooting band karantu.
Stop shooting.	Shooting band karantu.
Stop shooting.	Shooting band karantu.
Stop shooting.	Shooting band karantu.
Stop shooting.	Shooting band karantu.
Stop shouting.	Chitkara band kara.
Stop shouting.	Chitkara band kara.
stop that     	seta band kara
stop that     	seta band kara
stop them    	 seta rakhidia
stop them     	seta rakhidia
stop!	band kara!
Stop! Thief!	rahija! chora!
Straighten up.	Sidha kara.
Straighten up.	Sidha kara.
Suit yourself.	Nijaku suit kara.
Suit yourself.	Nijaku suit kara.
Suit yourself.	Nijaku suit kara.
Suit yourself.	Nijaku suit kara.
Suit yourself.	Nijaku suit kara.
Suit yourself.	Nijaku suit kara.
Suit yourself.	Nijaku suit kara.
Suit yourself.	Nijaku suit kara.
Suit yourself.	Nijaku suit kara.
Suit yourself.	Nijaku suit kara.
Suit yourself.	Nijaku suit kara.
Suit yourself.	Nijaku suit kara.
sunday	rabibar
Sweep my room.	Mo room ku safa kara.
Sweep my room.	Mo room ku safa kara.
sweeper	jhadudar
sweet	mitha
Take	Niyo
Take a bus.	eko bus niiyo
Take a bus.	eko bus niiyo
Take a bus.	eko bus niiyo
Take a bus.	eko bus niiyo
Take a number.	Ek number niya.
Take a number.	Ek number niya.
Take a number.	Ek number niya.
Take a number.	Ek number niya.
Take a number.	Ek number niya.
Take a number.	Ek number niya.
take care    	jatna niya
take care    	jatna niya
Take cover!	aachadono koro
Take cover!	aachadono koro
Take cover!	aachadono koro
take it.	 Niya eita
take it. 	Niya eita
"Take me there, please"	mate seitthiki neijantu
take mine.   	Moro neijaya
take mine.   	Moro neijaya
Take only one.	Kebala gotiye niya.
Take only one.	Kebala gotiye niya.
Take only one.	Kebala gotiye niya.
Take only one.	Kebala gotiye niya.
Take only one.	Kebala gotiye niya.
Take only one.	Kebala gotiye niya.
take over.   	Neijaya
take over.   	Neijaya
Take these.	aaeguudiko niiyo
Take these.	aaeguudiko niiyo
Take these.	aaeguudiko niiyo
Take Tom home.	Tom ku gharaku nei jao.
Take Tom home.	Tom ku gharaku nei jao.
Take Tom home.	Tom ku gharaku nei jao.
Take Tom home.	Tom ku gharaku nei jao.
Talk to me!	mo soohito kotha huo
Talk to me.	mo soohito kotha huo
Taste this.	aeehaku swado karonti
Taste this.	aeehaku swado karonti
Tastes differ.	Swada bhinna ate.
Tastes differ.	Swada bhinna ate.
telephone	durabhasa
Tell me something about yourself.	Mote tuma bishayare kichhi kuha.
Tell us something about yourself. 	Amaku apananka bisayare kichi kuhantu
than are put into malaria.	Taapare malaria re rakhajaaye
Thank You	Dhanyavad
Thank you	thumbhanku dhanyabad
Thank you 	Dhanyabado 
Thank you for saving my life	Mo jibana bancaiba pal cahuchi
thank you.   	dhanyabaad
thank you.   	dhanyabaad
thanks	dhanyabaad
Thanks anyway.	Jaha heu dhanyabad.
Thanks anyway.	Jaha heu dhanyabad.
Thanks for the help.	Sahajya kariba pain dhanyabad
that	saita
That a boy!	se baadko
that all three have also been responsible in	Ehi teenijana madhya dayi atanti
That can't be.	Taha hoyi pariba nahi.
That can't be.	Taha hoyi pariba nahi.
That hurts.	aaeha koostdayako
That is a lie.	Taha ek mithya ate.
That is a lie.	Taha ek mithya ate.
That is the final lesson of the story	Taha heuchi kaahani ro antim shiksha
that it learns or is pre-programmed.	Je eha sikhe kimba pre programme kara jaye
That one's OK.	Taha thik achi.
That one's OK.	Taha thik achi.
That one's OK.	Taha thik achi.
That one's OK.	Taha thik achi.
That one's OK.	Taha thik achi.
That one's OK.	Taha thik achi.
That one's OK.	Taha thik achi.
That one's OK.	Taha thik achi.
That one's OK.	Taha thik achi.
That one's OK.	Taha thik achi.
That one's OK.	Taha thik achi.
That one's OK.	Taha thik achi.
That was easy.	Taha sahaj thila.
That was easy.	Taha sahaj thila.
That was fast.	Taha dhruta gatire thila.
That was fast.	Taha dhruta gatire thila.
That was loud.	Taha jogare thile.
That was loud.	Taha jogare thile.
That was mean.	Ehara artha thila.
That was mean.	Ehara artha thila.
That's a book.	Taha ek pustak.
That's a book.	Taha ek pustak.
That's a copy.	Taha ek copy.
That's a copy.	Taha ek copy.
That's a doll.	Taha ek posak.
That's a doll.	Taha ek posak.
That's a fact.	Taha eka satya.
That's a fact.	Taha eka satya.
That's a fact.	Taha eka satya.
That's a fact.	Taha eka satya.
That's a fake.	Taha eka nakli.
That's a fake.	Taha eka nakli.
That's a fake.	Taha eka nakli.
That's a fake.	Taha eka nakli.
That's a fish.	taha eka macha
That's a fish.	taha eka macha
That's a joke.	taha eka parihas
That's a joke.	taha eka parihas
That's a joke.	taha eka parihas
That's a joke.	taha eka parihas
That's a myth.	taha eka puran
That's a myth.	taha eka puran
That's a plan.	taha eka yojana
That's a plan.	taha eka yojana
That's a risk.	taha eka bipada
That's a risk.	taha eka bipada
That's a sign.	taha eka chinha
That's a sign.	taha eka chinha
That's a tree.	taha eka gacha
That's a tree.	taha eka gacha
That's all.	khali aaetiki
That's better.	taha bhala atey
That's better.	taha bhala atey
That's better.	taha bhala atey
That's better.	taha bhala atey
That's broken.	taha bhangigala
That's broken.	taha bhangigala
That's enough.	setiki jyatheshta
That's enough.	setiki jyatheshta
That's enough.	setiki jyatheshta
That's enough.	setiki jyatheshta
That's enough.	setiki jyatheshta
That's enough.	setiki jyatheshta
That's his.	taha tankoro oate
that's it      	eta hin 
that's it      	seta hin 
that's me     	seta mun 
That's my boy.	se mo pua
That's my boy.	se mo pua
That's my car.	taha mora car
That's my car.	taha mora car
That's my cat.	taha mora billi
That's my cat.	taha mora billi
That's my dog.	taha mora kukura
That's my dog.	taha mora kukura
That's my job.	taha mora kaam
That's my job.	taha mora kaam
That's new.	taha nua oatee
That's sad.	aaeha dukhodaayako
That's sad.	aaeha dukhodaayako
That's Saturn.	Taha heuchi sani.
That's Saturn.	Taha heuchi sani.
That's simple.	taha sarala atey
That's simple.	taha sarala atey
That's Tom.	taha hauchi tom
That's too expensive	seha bahaut damika
The blue and the dim	Neel eban andhakaar
the Carrier Hotel	carrier hotel
The cat is drinking the milk.	Bilei ta khira piu achi.
The color and opacity of the highlight border.	highlight simara ranga abang swachata
The cup broke.	cup bhangigala
The cup broke.	cup bhangigala
The default plugin layout for the bottom panel	tala panel pai default plugin layout
The default plugin layout for the top panel	upera panel pai default plugin layout
The duration of the highlight box when selecting accessible nodes	abhigamya nodegudikun bhanchibabele hilghlight boxara abhadhi
The ending portion of these Vedas is called Upanishad.	Ehi beda gudikara shesha bhaagku Upanishad kuha jaye
the family planning started in Vietnam and they went for smaller families.	Vietnam re paribaar yojna aarambh hoyithila eban semane chota paribaara payi jayithile
The girls won.	jhiamane jitile
The girls won.	jhiamane jitile
The girls won.	jhiamane jitile
The girls won.	jhiamane jitile
The girls won.	jhiamane jitile
The girls won.	jhiamane jitile
The girls won.	jhiamane jitile
The girls won.	jhiamane jitile
the other one	aaujana ku
The religious leaders were fully conscious of such problems and they tried to root out ' discrimination	Dharmik netamane ebhali samasya bishayare sampurna sachetan thile eban semane bhedbao door karibaku chesta karithile
"The then Governor of Kashmir resisted transfer , but was finally reduced to subjection with the aid "	Kashmir ra tatkalin rajyapal sthanantara ku pratirodha karithile kintu sheshare sahajyare ehaku adhin karidiagala
The weather is great today!	Aji ra paga bahut bhala acchi! 
then what?   	Tapare kn?
There are also financial reforms in rural China.	China ra gramanchala re madhya arthik sanskara rahichi
there are only 3 people in this group	ye group re khali teen jana achanti
There is hope.	bharasa achi
There is hope.	bharasa achi
there is no such thing like ghost	bhoota preta kichi nahi
There you are.	sethare tume
There you are.	sethare tume
they  went to the mosque	say mane mandira gale
They agree.	seemaane raazi huanti
They agree.	seemaane raazi huanti
They all knew.	semane samasta jaanithile
They all knew.	semane samasta jaanithile
They are busy.	semane byasta achanti
They are busy.	semane byasta achanti
They are busy.	semane byasta achanti
They are busy.	semane byasta achanti
They canceled.	semane batil kale
They canceled.	semane batil kale
They canceled.	semane mana kale
They canceled.	semane mana kale
They cheat.	semaane prtarna koronti
They cheat.	semaane prtarna koronti
They cheat.	semaane prtarna koronti
they fell      	semane padigalae
They found it.	semane eha paile
They found it.	semane eha paile
They found us.	semane amaku paile
They found us.	semane amaku paile
they lied.     	Semane micha khile
they lost      	semane harigale
They love Tom.	semane Tom ku bhala paanti
They love Tom.	semane Tom ku bhala paanti
They saved us.	semane amaku uddhara kale
They saved us.	semane amaku uddhara kale
They stood.	semaane theeya haehe
they swam.    	semane pahanrile
They tried.	seemaane chesta kolee
They vanished.	semane adrushya hele
They vanished.	semane adrushya hele
They will die.	semane maribe
They will die.	semane maribe
They'll be OK.	semane thik rahibe
They'll be OK.	semane thik rahibe
They'll do it.	semane kariba karibu taha
They'll do it.	semane kariba karibu taha
They're awake.	semane jaagrit achanti
They're awake.	semane jaagrit achanti
They're crazy.	semane pagal
They're crazy.	semane pagal
They're fools.	semane murkha
They're fools.	semane murkha
They're happy.	semane khusi achanti
They're happy.	semane khusi achanti
They're quiet.	semane chup achanti
They're quiet.	semane chup achanti
They're quiet.	semane chup achanti
They're quiet.	semane chup achanti
They're quiet.	semane chup achanti
They're quiet.	semane chup achanti
They're spies.	semane guptachara achanti
They're spies.	semane guptachara achanti
They're upset.	semane birakta hoyichanti
They're upset.	semane birakta hoyichanti
They're wrong.	semane bhul karichanti
They're wrong.	semane bhul karichanti
They're wrong.	semane bhul karichanti
They're wrong.	semane bhul karichanti
Thia is a good idea	Aeha eko bhalo dharona
Things change.	jinisha badalijaye
Things change.	jinisha badalijaye
This change has contributed	Ehi paribartana sahajyoga karichi
This changed slowly	Eha dhire dhire badaligala
This city is too beautiful	Ehi sahar ti bohut sundar
this gentleman will pay for everything	sei lok sabu kichi pai paisa debe
This is a dog.	eha eka kukura
This is a dog.	eha eka kukura
This is a dog.	eha eka kukura
This is a dog.	eha eka kukura
This is a DVD.	eha eka DVD atey
This is a DVD.	eha eka DVD atey
This is a map.	eha eka maanachitra
This is a map.	eha eka maanachitra
This is a pen.	eha eka kalama
This is a pen.	eha eka kalama
This is a pun.	eha eka danda atey
This is a pun.	eha eka danda atey
This is crazy.	eha maja atey
This is crazy.	eha maja atey
This is crazy.	eha maja atey
This is crazy.	eha maja atey
This is funny.	eha majaliya atey
This is funny.	eha majaliya atey
This is it.	aeehahi
This is Japan.	eha heuchi Japan
This is Japan.	eha heuchi Japan
This is me.	eea hauchi mu
This is my CD.	eha mora CD
This is my CD.	eha mora CD
This is Tom's.	eha heuchi Tom ra
This is Tom's.	eha heuchi Tom ra
This is weird.	eha bichitra atey
This is weird.	eha bichitra atey
this lady will pay for everything	sei mahila sabu kichi pai paisa debe
this mattress only doesn∆t suit me	ye gaddi ka paduni mate
This percentage is even greater than the percentage in India.	Ehi Shatakda Bharatara shatakda tharu adhik
This period summarily is pepped up with devotion.	Ehi abardha sankhepare bhakti sahita pep hoyijaye
This place is near from market	Ehi sthana bajar tharu pakhare
this week	ehi saptaha
three	teeni
Three: this is a good road in - right near where our factory is located.	Teenoti eha heuchi eka bhala rasta jeuthare amara karkhana abasthita
Thursday	gurubar
tied up	bandhideli
Time is money.	samaya hi paisa
Time is money.	samaya hi paisa
Time is up.	somoyo soorijayichi
to eat	khaibaku kichi daini
to village	gaan ku
today	aaji
today	gata kali
Tom adores me.	Tom mote aadar karanti
Tom adores me.	Tom mote aadar karanti
Tom adores me.	Tom mote aadar karanti
Tom adores me.	Tom mote aadar karanti
Tom agreed.	tom raazi haele 
Tom agreed.	tom raazi haele 
Tom agrees.	tom raazi haele 
Tom applauded.	Tom kartali heithile
Tom applauded.	Tom kartali heithile
Tom applauded.	Tom kartali heithile
Tom applauded.	Tom kartali heithile
Tom applauded.	Tom kartali heithile
Tom applauded.	Tom kartali heithile
Tom applauded.	Tom kartali heithile
Tom applauded.	Tom kartali heithile
Tom applauded.	Tom kartali heithile
Tom applauded.	Tom kartali heithile
Tom applauded.	Tom kartali heithile
Tom applauded.	Tom kartali heithile
Tom ate alone.	Tom ekuthiya khaile
Tom ate alone.	Tom ekuthiya khaile
Tom ate alone.	Tom ekuthiya khaile
Tom ate alone.	Tom ekuthiya khaile
tom ate.	 Tom khaila
tom ate. 	Tom khaila
Tom bit me.	tom moote kaamudela
Tom blames us.	Tom aamaku dayi karanti
Tom blames us.	Tom aamaku dayi karanti
Tom burped.	tom photigola
Tom burped.	tom photigola
Tom called me.	Tom mote dakile
Tom called me.	Tom mote dakile
Tom called.	tom daakeele 
Tom came here.	Tom ethaku asithili
Tom came here.	Tom ethaku asithili
Tom can do it.	Tom eha kari paribi
Tom can do it.	Tom eha kari paribi
Tom can't ski.	Tom ski kari paribe nahi
Tom can't ski.	Tom ski kari paribe nahi
Tom cheats.	tom thok
Tom cheats.	tom thok
Tom cheats.	tom thok
Tom confessed.	Tom swikaar karichanti
Tom confessed.	Tom swikaar karichanti
Tom confessed.	Tom swikaar karichanti
Tom confessed.	Tom swikaar karichanti
Tom cried      	Tom kandila
Tom danced.	tom nachila
Tom did do it.	Tom eha kala
Tom did do it.	Tom eha kala
Tom did it.	tom aeha kola
Tom did it.	tom aeha kola
Tom disagreed.	Tom ethire sehmat nuhanti
Tom disagreed.	Tom ethire sehmat nuhanti
Tom disagreed.	Tom ethire sehmat nuhanti
Tom disagreed.	Tom ethire sehmat nuhanti
Tom disagreed.	Tom ethire sehmat nuhanti
Tom disagreed.	Tom ethire sehmat nuhanti
Tom dozed     	Tom ghungudi maruchi
Tom drives.	tom drive
Tom drives.	tom drive
Tom exercised.	Tom byayam kale
Tom exercised.	Tom byayam kale
Tom exercised.	Tom byayam kale
Tom exercised.	Tom byayam kale
Tom failed.	tom  bifaulo hela 
Tom failed.	tom bifaulo hela
Tom felt fine.	Tom ku bhala lagila
Tom felt fine.	Tom ku bhala lagila
Tom felt sick.	Tom asustha anubhaba kale
Tom felt sick.	Tom asustha anubhaba kale
Tom forgot.	tom bhuligole
Tom forgot.	tom bhuligole
Tom fought.	tom yuudh kole
Tom found one.	Tom gotiye paile
Tom found one.	Tom gotiye paile
Tom found one.	Tom gotiye paile
Tom found one.	Tom gotiye paile
Tom found one.	Tom gotiye paile
Tom found one.	Tom gotiye paile
Tom gasped.	tom gasp kole
Tom gasped.	tom gasp kole
Tom goofed.	tom gofhede
Tom got a job.	Tom eka chakiri paila
Tom got a job.	Tom eka chakiri paila
Tom got up.	tom uthile
Tom graduated.	Tom snataka haasil kala
Tom graduated.	Tom snataka haasil kala
Tom graduated.	Tom snataka haasil kala
Tom graduated.	Tom snataka haasil kala
Tom graduated.	Tom snataka haasil kala
Tom graduated.	Tom snataka haasil kala
Tom had a cat.	Tomankara eka billi thile
Tom had a cat.	Tomankara eka billi thile
Tom had a dog.	Tomankara gotiye kukura thila
Tom had a dog.	Tomankara gotiye kukura thila
Tom had a gun.	Tom pakhare banduk thila
Tom had a gun.	Tom pakhare banduk thila
Tom had a son.	Tomankara eka pua thila
Tom had a son.	Tomankara eka pua thila
Tom had a son.	Tomankara eka pua thila
Tom had a son.	Tomankara eka pua thila
Tom has a car.	Tomankara eka Car achi
Tom has a car.	Tomankara eka Car achi
Tom has a car.	Tomankara eka car achi
Tom has a dog.	Tomankara gotiye kukura achi
Tom has a gun.	Tom pakhare eka banduk achi
Tom has a job.	Tomankara eka chakiri achi
Tom has a map.	Tomankara eka maanachitra achi
Tom has a map.	Tomankara eka maanachitra achi
Tom has to go.	Tom ku jibaku padiba
Tom helped.	tom saahajya kole
Tom helped.	tom saahajya kole
Tom hesitated.	Tom dwidhabodha kale
Tom hit me.	tom moote maarele
Tom hugged me.	Tom mote alingana kala
Tom hugged me.	Tom mote alingana kala
Tom hugged me.	Tom mote alingana kala
Tom is a fool.	Tom jane murkha
Tom is a hero.	Tom jane hero
Tom is a slob.	Tom eka slob
Tom is a wimp.	Tom eka wimp
Tom is absent.	Tom anupasthit
Tom is afraid.	Tom bhaybhit achi
Tom is asleep.	Tom soichi
Tom is biased.	Tom pakhyapatit
Tom is big.	tom bodo
Tom is boring.	Tom biraktikara
Tom is coming.	Tom asuchi
Tom is crying.	Tom chitkara
Tom is crying.	Tom rouchi
Tom is dozing.	Tom dozing karuchanti
Tom is dozing.	Tom dozing karuchanti
Tom is frugal.	Tom falprad atey
Tom is frugal.	Tom falprad atey
Tom is fun.	tom mouja oate
Tom is hiding.	Tom luchi rahichi
Tom is hiding.	Tom luchi rahichi
Tom is ill.	tom aswasth aachonti
Tom is joking.	Tom maja leuchanti
Tom is joking.	Tom thatta karuchanti
Tom is joking.	Tom thattha karuchanti
Tom is mad.	tom pagolo
Tom is my dad.	Tom mora bappa
Tom is my dad.	Tom mora bappa
Tom is my dad.	Tom mora bappa
Tom is new.	tom nua aaoate
Tom is now up.	Tom bartamaan uthichi
Tom is odd.	tom auduaa
Tom is old.	tom purana
Tom is paying.	Tom deya deuchanti
Tom is sad.	tom dukhito
Tom is scared.	Tom bhayabhit achi
Tom is shy.	tom lajkuda
Tom is simple.	Tom saral atey
Tom is strong.	Tom shaktishali
Tom is thirty.	Tom 30 barsa
Tom is unkind.	Tom dayalu nuhanti
Tom is wet.	tom ooda aachi
Tom is wicked.	Tom dusta atey
Tom jumped.	tom deipodela
Tom kept warm.	Tom garam rahila
Tom knits      	Tom Sileiyi kre
Tom knows     	Tom janichi
Tom knows her.	Tom taanku jananti
Tom knows him.	Tom tanku jananti
Tom knows why.	Tom kahiki jananti
Tom left town.	Tom sahara chadhi chali gale
Tom looked up.	Tom uparaku chahila
Tom looked up.	Tom uparaku dekhila
Tom looked.	tom dekhele
Tom looks sad.	Tom dukhi dekha jauchi
Tom loves you.	Tom tumaku bhala paye
Tom loves you.	Tom tumaku bhala paye
Tom loves you.	Tom tumaku bhala paye
Tom moaned.	tom kridrono kole
Tom moaned.	tom kridrono kole
Tom moved     	Tom gala
Tom nodded.	tom aanethaee dele
Tom obeyed.	tom maanele
Tom obeyed.	tom maanele
Tom obeyed.	tom maanele
Tom obeyed.	tom maanele
Tom overslept.	Tom adhik soyithile
Tom paused.	tom birokto haele
Tom phoned.	tom phone kole
Tom phoned.	tom phone kole
Tom prayed.	tom prarthana kole
Tom prayed.	tom prarthana kole
Tom protested.	Tom ehaku birodh karithile
Tom raised me.	Tom mote banchaila
tom ran.	 Tom daudila
tom ran. 	Tom daudila
Tom recovered.	Tom sustha hela
Tom remembers.	Tom ku mane achi
Tom rushed in.	Tom bhitaraku daudigale
Tom rushed in.	Tom bhitaraku daudigale
Tom rushed in.	Tom bhitaraku daudigale
Tom rushed in.	Tom bhitaraku daudigale
Tom said that.	Tom eha kahichanti
Tom said that.	Tom eha kahichanti
Tom saw it.	tom aaeha dekhile
Tom saw it.	tom aaeha dekhile
Tom saw me.	tom mopte dekhile 
Tom saw us.	tom aamoko dekhile
Tom set me up.	Tom mote set up kala
Tom shaved.	tom shave kole
Tom shaved.	tom shave kole
Tom shot Mary.	Tom Mary ku goli marila
Tom sighed.	tom dirgho niswas pokaele
Tom smiled.	tom hoosela
Tom snores.	tom snores
Tom spoke     	Tom khila
Tom staggered.	Tom Chida hoigale
Tom stayed.	tom rohile
Tom stayed.	tom rohile
Tom succeeded.	Tom safal hela
Tom swims     	Tom pahanrila
Tom talked.	tom kootha haela
Tom talked.	tom kotha haela
Tom texted me.	Tom mote message kale
Tom tried      	Tom chesta krila
Tom trusts me.	Tom mote Biswas kare
Tom trusts us.	Tom aama upare biswas karanti
Tom voted      	Tom vote dela
Tom waited.	tom apaksha kale
Tom walked.	tom chalela
Tom walked.	tom chalela
Tom walks      	Tom chalila
Tom was a spy.	Tom eka guptachara thila
Tom was alone.	Tom ekuthiya thila
Tom was angry.	Tom ragigala
Tom was bored.	Tom birakta hoigale
Tom was dirty.	Tom maila thila
Tom was drunk.	Tom madyapaan karithile
Tom was fired.	Tomanku barkhaast karajai thila
Tom was frank.	Tom kholakholi thile
Tom was lucky.	Tom bhagyaban thile
Tom was quick.	Tom shighra thila
Tom was scary.	Tom bhaybhit thila
Tom was sober.	Tom subrat thile
Tom was sweet.	Tom mitha thila
Tom was tired.	Tom thaki jayithile
Tom was upset.	Tom bibrat hele
Tom was upset.	Tom dukhi hele
Tom wasn't in.	Tom bhitaraku na thile
Tom went pale.	Tom fika padi gala
Tom went pale.	Tom fika padi gala
Tom went west.	"Tom pashchi, ku gala"
Tom will cook.	Tom randhiba
Tom will fail.	Tom bifala heba
Tom will fail.	Tom bifala heba
Tom will obey.	Tom mainba
Tom will talk.	Tom katha hebe
Tom will wait.	Tom apekhya kariba
Tom will walk.	Tom chaliba
Tom will walk.	Tom chaliba
Tom will work.	Tom karjya kariba
Tom winked.	tom aankh bujhidela
Tom won again.	Tom punarbara jitila
tom won. 	Tom jeeti gala
tom won. 	Tom jeeti gala
Tom won't stop.	Tom band hebo nahi
Tom wore a hat.	Tom topi pindhithile
Tom worked.	tom kaam kole
Tom worked.	tom kaam kole
Tom works     	Tom kama krila
Tom works hard.	Tom kathinayi parishram kare
Tom yawned.	tom hoelaela
Tom yelled.	tom chirkaro kole
Tom yelled.	tom chirkaro kole
"Tom, answer me!"	Tom mate uttara dia
"Tom, don't die."	Tom mara nahi
"Tom, I'm hungry."	tom mu bhokila aachii
Tom'll cry.	tom kaandibo
Tom'll die.	tom mooribo
Tom'll go       	Tom  jiba
Tom'll pay.	tom debe
tommorrow	kali
tomorrow	asnta kali
Tom's a grouch.	Tom ra grouch
Tom's adopted.	Tom garahan karichanti
Tom's amazing.	Tom ashcharyajanak
Tom's annoyed.	Tom annoyed achi
Tom's anxious.	Tom chintit
Tom's bleeding.	Tom raktashraba
Tom's busy.	tom boyost
Tom's Canadian.	Tom ra canadian
Tom's charming.	Tom ra akarshaniya
Tom's cheerful.	Tom khusi
Tom's choking.	Tom chok karuchi
Tom's choking.	Tom chok karuchi
Tom's confused.	Tom dwanda re
Tom's cooking.	Tom randhiba
Tom's divorced.	Tom chadapatra
Tom's elderly.	Tom brudha
Tom's engaged.	Tom niyajeet
Tom's fainted.	Tom hetash hoigale
Tom's fearless.	Tom nirbhaya
Tom's finished.	Tom samapta hoichi
Tom's finished.	Tom samapta hoichi
Tom's gone.	tom chaligola
Tom's grieving.	Tom kan dukha
Tom's grinning.	Tom ra hasa khusi
Tom's harmless.	Tom ra niriha
Tom's healthy.	Tom sustha achanti
Tom's here.	tom aethare aachi
Tom's homeless.	Tom kan bhumi hina
Tom's hungover.	Tom ra sikara
Tom's hurt.	tomnko aaghto
Tom's impressed.	tom probhabito
Tom's innocent.	Tom niriha
Tom's laughing.	Tom hasuchi
Tom's left.	tom bamo
Tom's limping.	Tom ra anga pratyanga
Tom's limping.	Tom ra anga pratyanga
Tom's mad      	Tom pagala heijaichi
Tom's mean.	tom ro aarth
Tom's missing.	Tom nikhoja
Tom's my cousin.	tom moro somwakriyo
Tom's my friend.	tom moro bondhu
Tom's not busy.	Tom byasta nuhanti
Tom's out cold.	Tom thanda hoigala
Tom's packing.	Tom pcking karuchi
Tom's sad     	 Tom dukhi achi
Tom's safe.	tom surokshito
Tom's shy      	Tom laja kruchi
Tom's sick.	tom aswasth aachonti
Tom's singing.	Tom geeta gauchi
Tom's sleeping.	Tom soichi
Tom's strange.	Tom ajab
Tom's swimming.	Tom santaranna
Tom's thirsty.	Tom shoshila
Tom's ugly.	tom asubh
Tom's upstairs.	Tom upara mahala re
Tom's useless.	Tom ra adarkaari
Tom's very sad.	Tom bohut dukha
Tom's weak.	tom durbolo
Tom's wounded.	Tom aahat
Tom's wounded.	Tom aahat hoijaichi
Tough luck!	koothin bhagyo
Treat her well.	Tara bhala bhyabahara kara
Treat him well.	Tanku bhala bhyabahara kara
tree	gacha 
Trust is earned.	biswas arjon korajaaye
trust Tom.     	Tom ku biswas kra
Trust your gut.	Tumara          upara biswas kara
Try again      	Chesta kra
Try and do it.	chesta kara eban kara
Try and do it.	Chesta kri kaam kara
Try and stop me.	moute chesta karo aiwam bandho karo
Try and stop me.	moute chesta karo aiwam bandho karo
Try harder.	aadhiko chesta karonti
Try harder.	aadhiko chesta karonti
Try harder.	aadhiko chesta karonti
try it	ehaku chesta kara
try it again.    	Authare chesta kra
Try not to fall.	no padibaku chesta karonti
Try not to fall.	no padibaku chesta karonti
Try not to fall.	no padibaku chesta karonti
Try not to yawn.	joono nokaribaku chesta karonti
Try this candy.	Ehi candy ku chesta karantu
Try this sauce.	Ehi sauce ku chesta karantu
Try to catch me.	moote dharibaku chesta koro
Try to catch me.	moote dharibaku chesta koro
Try to remember.	moonerakhi baku chesta karonti
Try to remember.	moonerakhi baku chesta karonti
Tuesday	mangalbar
Turn it up.	aaehako turn up karonti
Turn off the tv	Tv band kara
Turn off the TV.	TV bondho karonti
Turn off the TV.	TV bondho karonti
Turn off the TV.	TV bondho karonti
Turn on the gas.	gas turn on karonti
Turn on the TV.	Tv turn on karantu
Turn right.	dahanoku bulntu
turn the bag	baulai dia se bag ta
Turn up the TV.	Tv turn off karantu
Turn up the TV.	TV turn off karantu
Turn up the TV.	TV turn off karantu
Twenty of the years from 1860 to 1908 were years of famine	1860 ru 1908 parjyanta kodiye barsa durbhikhya ra barsa thila
two	dui
two o'clock AM	rati duita
u are great	tu ta mahan
u bought tickets	ticket kinilu
u didnt understand what I said	mu jauta kahichi tu bujhipariluni
u don∆t go	tame na jaa
u have more tension for me going away	mu jibi tate besi chinta
U know	Tate jana
u(almost same age)	tame 
u(to address someone elder)	aapana
umbrella	chata
unable to forget	bhuliparuni
Unlock the door.	kobato kholo
Unlock the door.	kobato kholo
Use your charm.	Tumara chamatkara bhyabahara karantu
Use your feet.	tumara paad byabahaara kara
Use your fist.	tumara paad byabahaara kara
Very good.	Bohut badhiya.
Vishnusahastranam - Glory of Vishnu's 1000 names in Shantiparva.	Bishusahastranam shanti ra bhare bishunka 1000 namara gouraba
Wait a moment.	kichi samaya apekhya kara
Wait a moment.	kichi samaya apekhya kara
Wait a moment.	kichi samaya apekhya kara
Wait a moment.	kichi samaya apekhya kara
Wait a sec.	eko sekend aapecha karnti
Wait a sec.	eko sekend aapecha karnti
Wait a sec.	eko sekend aapecha karnti
Wait a second.	ek second apekhya kara
Wait a second.	ek second apekhya kara
Wait a second.	ek second apekhya kara
Wait one second.	gotiye second apakshya koro
Wait till six.	6 parjyanta apekhya kara
Wait till six.	6 parjyanta apekhya kara
wait up. 	Tike apeksha kara
wait up. 	Tike apeksha kara
wait!	ruha!
"Wait, you guys."	"Hey pilamane, apekhya kara"
wake that piyush	se piyush ku uthaila
wake up.	 Utha tome
wake up. 	Utha tome
walk	chaliba
Walk this way.	ehi patha chala
Walk this way.	ehi patha chala
Walking is nice.	chaliba bholo aate
Walls have ears.	kachare kaano aachi
Walls have ears.	kachare kaano aachi
Was I snoring?	mu snana karuthile ki?
Was it a joke?	eha eka parihas thila ki?
Was it fun?	aeha mooja thila ki 
"Was it you, Tom?"	tume tom
was playing	kheluthili
Was that a no?	taha nuhe ki?
Was that a yes?	Eha eka han thila ki?
Was Tom fired?	Tom ku barakhaasta karajaithila ki?
Was Tom fired?	Tom ku barakhaasta karajaithila ki?
Was Tom funny?	Tom majakiya thila?
Was Tom happy?	Tom khusi thila ki?
Was Tom there?	Tom sethare thile ki?
Wash your face.	Muha dhoi dia
Wash your feet.	Pado dhoi dia
Wash your feet.	Pado dhoi dia
Wash your hands.	haato dhoi diyo
washerman	dhoba
Watch carefully.	yonuro soho dekhonti
Watch carefully.	yonuro soho dekhonti
Watch carefully.	yonuro soho dekhonti
Watch closely.	ati nikataru dekhantu
Watch closely.	ati nikataru dekhantu
Watch closely.	ati nikataru dekhantu
Watch closely.	ati nikataru dekhantu
Watch my back.	mora pithi dekhantu
Watch the road.	Rasta dekhantu
Watch the road.	Rasta dekhantu
Watch the road.	Rasta dekhantu
watch Tom     	Tom ku dekha
Watch your step.	tomoro paadonko dekho
Watch your step.	tomoro paadonko dekho
Watch your toes.	aaponoko ro aanguthi dekhonti
Watch yourself.	Nijaku dekhantu
Wax the floor.	chattanaku maham karantu
"Way to go, Tom!"	"Jibara bato, Tom"
"Way to go, Tom!"	"Jibara bato, Tom"
"Way to go, Tom!"	"Jibara bato, Tom"
we agreed.     	me raji helu
We all die.	aame somost mooriba
We all knew it.	Ame samaste eha janithilu
We all like him.	aame somosto taaku pasondo kore
We all love Tom.	aame somoste tom ku bholopaaye
We all love you.	aame somoste tumoku bholo ppau
We already ate.	Ame purbaru khaisarichu
We are afraid.	aame bhaybhit
We are afraid.	aame bhaybhit
we are all going	aame samaste jauchu
We are at home.	Ame ghare achu
We are brothers.	aame bhai
We are coming.	aame aasuchu
We are cousins.	Ame jwain
We are crying.	aame kanduchu
We are doctors.	Ame doctor attu
We are doomed.	aame binashta
We are his sons.	aame maane taanko ro putro
We are hungry.	aame bhokila
We are in Paris.	aame paris re aachi
We are men.	aame puruso
We are students.	aame chatro aootu
We are students.	aame chatro aootu
We are the best.	aame sarvootum
We aren't alone.	aame aaeka nuhe
We ate together.	aame aakathi khailu
We both saw you.	aame duhe tumoko dekhile
We buy CDs.	aame CD kiniba
We can help Tom.	aame tom ku sahiyota koriparibu
We can help you.	aame aapnoko sahajyo karipariba
We can help you.	aame aapnoko sahajyo karipariba
We can pay.	aame dayo deyipaariba
We can proceed.	Ame agrogati karipariba
We can win.	aame jitiba
We can win.	aame jitiba
We can't do it.	Ame eha kariparibu nahi
We can't do it.	Ame eha kariparibu nahi
We can't escape.	aame ghosi paaribu nahi
We can't lose.	aame harayi paribu nahi
We can't see it.	aame aahaku dekhiparu nahi
We can't wait.	aame apekhya kariparibu nahi
We count on you.	aame tumo upore bhorosa kore
We didn't try.	aame chesta kari nahi
We don't know.	aame jani nahi
We drank a lot.	Ame bohut peelu
We exaggerated.	Ame atirikta karichu
We fell asleep.	Ame soipadilu
We forgive him.	Ame tanku khyama karidau
We found them.	aame semananku pailu
We got dressed.	Ame poshaka pindhilu
We got married.	Ame bibaha kalu
We got married.	Ame bibaha kalu
We had a blast.	Ame eka bisphotrana hoithile
We had a fight.	Amara jhagada hoithila
We had a plan.	aamara eka yojana thila
We had doubts.	aamara sandeha thila
We had fun.	aame mooja korithilu
We had to come.	Amaku asibaku padila
We had to stop.	Amaku band karibaku padila
We had to stop.	Amaku band karibaku padila
We had to walk.	Amaku chalibaku padila
We have a guest.	aamoro jone othiti oochonti
We have a plan.	Amara ek jojana achi
We have arrived.	aame pohuchichi
We have changed.	aame paribortono karichi
We have changed.	aame paribortono karichi
We have changed.	aame paribortono karichi
We have guests.	Amara atithi mane achanti
We have guests.	Amara atithi mane achanti
we have not eaten yet	aame toh khainu na
We have to go.	aamaku jibaku padiba
We have to talk.	 aamoku kotha heebaku podibo
We knew enough.	Ame jathesta jani thilu
We knew no one.	Ame kahaku jani nathilu
We lack nothing.	aamoro kiichii abhav nahi
We love coffee.	Ame coffee bhala pae
We love picnics.	aame picnic bholo paaye
We love you all.	aame tumo somostonku bholo paaye
We made him cry.	aame taanku kaandhilu
We made waffles.	aame waffles tiyari kolu
We met a writer.	aame joone lakhonku bhetile
We met earlier.	Ame purba ru bheti thilu
We must find it.	aame aahaku khojiba jaururi
We must find it.	aame aahaku khojiba jaururi
We must find it.	aame aahaku khojiba jaururi
We need a hero.	Ama ku jane hi hero darkar
We need a plan.	Ama ku eka jojona darkar
We need experts.	aamoku bisesdho dorkaro
We need more.	Amaku adhika darkar
We need this.	Amaku eha darkar.
We need to eat.	Ama ku khaiba abashyaka
We need to know.	aamku jaaniba aabosyook
We need to talk.	aamoku kootha heba aabosyok
We need to talk.	aamoku kootha heba aabosyok
We need to win.	Ama ku jitiba ku padiba
We pay Tom well.	aame tom ku bholo paau
We pay Tom well.	aame tom ku bholo paau
we saw it       	ame dekhilu
We shook hands.	Ame hatha halailu
We should go.	Ame jiba uchitt.
We should study.	aame adyayan kariba uuchit
We study Arabic.	aame arabic adhyayan koru
We study French.	aame farsi adhyayan koru
We study music.	Ame sangeeta adhyana karu
We succeeded!	Ame safala helu.
We succeeded.	Ame safala helu.
We surrendered.	Ame atmasamarpana kalu
We trust him.	Ame tanka upare biswas karu.
We trusted Tom.	Ame Tom upare biswasa karu thilu
We trusted Tom.	Ame Tom upare biswasa karu thilu
We try our best.	aame jothasombhav chesta koru
We volunteered.	Ame swechasebi
We volunteered.	Ame swechasebi
we waited.      	ame apekhsya krilu
We walked a lot.	aame bohut chalelu
We walked here.	Ame ethaku galu
We walked here.	Ame ethaku galu
We want it back.	aame aahaku pheraeba ku chahuchi
We want it back.	aame aahaku pheraeba ku chahuchi
We want justice.	aame nayayo chahuchi
We want to help.	aame saahajyo karibaku chahuchi
We went on foot.	aame pado re golu
We were busy.	Ame byasta thilu.
We were friends.	aame bandhu thilu
We were in love.	aame premo re thilu
We were sick.	Ame asushtha thilu.
We were wasted.	Ame nasta hoi galu
We were wasted.	Ame nasta hoyi galu
We were worried.	aame chintit thilu
we will go tommorrow	kaali ta jibu
we will return	aame palai asibu
"weather how much you do ,no profit"	jete kara kichi fayda nahi
weaver	tanti
wednesday	budhabar
week	saptaha
welcome	Sb?¸gata
Welcome back.	Puni thare swagat.
Welcome home.	Gharaku swagat.
Welcome to this event.	Apananku ehi utsaba ku swagata
welcome.	 Swagatam
welcome. 	Swagatam
We'll attack.	Ame akaramana karibu.
We'll attack.	Ame akramana karibu.
We'll be there.	Ame sethare rahibu
We'll call you.	Ame apanku dakibu
We'll call you.	Ame apna ku dakibu
We'll call you.	Ame apna ku dakibu
We'll call you.	Ame apna ku dakibu
We'll camp here.	aame aathare camp karibu
We'll camp here.	aame aathare camp karibu
We'll chance it.	aame aaehaku sujogo debu
We'll continue.	Ame jari rakhiba
We'll continue.	Ame jari rakhiba
We'll cook.	aame khaana tiyari kareeba
We'll cooperate.	aame sohjogo karibu
We'll cooperate.	aame sohjogo karibu
We'll cooperate.	aame sohjogo karibu
We'll decide.	Ame sthira karibu.
"Well done, Tom."	"Bhala kamo,Tom"
We'll find out.	Ame janiba
We'll know soon.	aame shighro jaamiba
We'll miss you.	Ame tumaku mane pakaibu
We'll miss you.	Ame tumaku mane pakaibu
We'll obey.	aame maaniba
We'll paint it.	Ame eha ku ranga kariba
We'll scream.	Ame chitkara karibu.
We'll see to it.	aame aaehaku dekiba
we'll see.       	ane dekhibu
We'll sing.	aame geeto gaaeba
We'll starve.	Ame bhokare rahibu.
We'll stay here.	aame aaethare rohibu
we'll try        	ame chesta kribu
We'll wait here.	aame aaethare aapeshya karibu
We'll wait.	aame aapeshya kareebu
We'll walk.	aame chaleeba
We'll walk.	aame chaleeba
we'll win.       	ame jitibu
We'll work.	aame kaam kareba
"Well, let's go."	"Acha, chalo jiba"
"well,lets go"	chalo jiba
We're a family.	Ame eka paribara
We're afraid.	Ame bhayabhita.
We're afraid.	Ame bhayabhita.
We're all alone.	aame samosto eka aachi
We're all done.	Ame samaste samapta
We're all going.	aame somoste jaauchi
We're all going.	aame somoste jaauchi
We're all happy.	aame somoste khusi
We're back.	aame fhari aasichu
We're back.	aame fhari aasichu
were being produced.	Utpadana karijauthila
We're biased.	Ame pakhyapatita.
We're brothers.	Ame bhai
We're busy.	aame byosto aachi
We're Canadians.	aame canadian
We're closed.	Ame band hoijaichhu.
We're cold.	aame thonda
We're coming.	Ame asuchhu.
We're dating.	Ame dating karuchhu.
We're decisive.	Ame nirnayaka
We're divorced.	Ame chadapatra paichu
We're doomed.	Ame dosi.
We're escaping.	Ame palayana karuchu
We're even.	aame aaporiki
We're fighting.	Ame judya karuchu
We're fine.	aame bholo re aachi
We're grateful.	Ame krutagya
We're helpless.	Ame asahaay
We're hiding.	Ame luchauchhu.
We're hiding.	Ame luchauchhu.
We're home.	aame ghore aachi
We're horrible.	Ame bhayankar
We're horrible.	Ame bhayankar
We're joking.	Ame thatta karuchhu.
We're joking.	Ame thatta karuchhu.
We're late.	aame bidombo koruchi
We're late.	aame bidombo koruchi
We're lazy.	aame aadosuaa
We're losing.	Ame haruchhu.
We're not busy.	Ame byasta nuha
We're not lost.	Ame hazi nahu
We're partners.	Ame ansidaar
We're paying.	Ame deya deuchhu.
We're reliable.	Ame nirbhara jogya
We're rich.	aame dhani
We're shooting.	Ame shooting karuchu
We're standing.	Ame chida hoichu
We're starving.	Ame bhoka re achu
We're starving.	Ame bhoka re achu
We're students.	Ame chatra atu
We're students.	Ame chatra atu
We're the best.	Ame sarwotama
Were they here?	Semane ethare thile ki?
Were they here?	Semane ethare thile ki?
We're too late.	Ame bahuta deri karichu
We're trying.	Ame chesta karuchhu.
We're weak.	aame durobolo
Were you there?	Tume sethare thila ki?
We've found it.	Ame eha ku pailu
We've found it.	Ame eha ku pailu
We've found it.	Ame ehaku pailu
We've got time.	Ama pakhare samaya achi
We've seen him.	Ame tanku dekhichu
we've won        	ame jiti sarichu
what	kana
what	kana re
What a big dog!	Ki bada kukura
What a hot day!	Kete garama dina
What a loser!	Kete hari.
What a loser!	Kete hari.
What a shame!	Lajja janak.
What a shame!	Lajja janak.
what amma! So much studies	kana maa! Kete patho
What are u doing?	Tome kan karucha ?/ Aapana kan karu chanti ?
What are uh eating	Aapan ki khau chanti
What are you doing	Kana karuchu
What are you doing	Kn karuchuuu tu
What are you doing ?	Kn karucha ?
What are you doing ?	Tame kan karucha ?
What are you doing ?	Tame kana karucha ?
What are you doing ?	Tame kana karucha ?
What are you doing ?	Tame kana karucha ?
What are you doing ?	Tame kn karucha ?
What are you doing today?	Tme aaji kana karucha?
What are you doing?	Tame kn karucha?
What are you doing?	Tame kn krucha?
What are you doing?	Tume kana karucha?
What are you doing? 	Kan karuchu? 
What are you doing? 	Kn karucha? 
What are you doing? 	Tame kana karucha ? 
What are you doing? 	Tame kana karucha? 
What are you eating?	Kn khaucha tame?
What are you eating?	Tame kana khaucha?
What are your plans after the classes?	Classes sarila pare kan plans achi?
what did he/she do	kan kala se
what did I buy now	kana kinili ebe
What did you eat for lunch?	Dui prahara re kan khaila?
What do I have?	Mora kana achi?
What do I need?	Mu kana abashyaka kare?
What do u want to eat ?	Tame  kana khaiba ?/ Aapana kana khaibe ?
What do we do now?	Ebe kan kariba?
What do we owe?	Amora kana runi?
What do you do?	Tume kana kara?
What do you want to know ?	Kana janibaku chauncha ?
what else	aau kana
what else can I write	aau kete lekhibi
what else?      	Au kn? 
What gives?	kono diye?
What gives?	kono diye?
What happened? 	Kono hela ?
What is it for?	Eha kana pain?
What is it for?	Eha kana pain?
What is it now?	Bartaman eha kana?
what is it written here	aithi kana lecha haichi
What is it?	aeha kona
What is it?	aeha kono
What is love?	Prema kana ate ?
What is that?	Taha kana ?
What is the name of your school?	Tama school ra naa kana?
What is the name of your sister-in-law?	Tama sali/bhauja nka naa kn?
What is this?	Eha kana ate ?
What is this?	Eha kana ate ?
What is this?	Eha kana ate ?
What is your age?	Tamara bayasa kete?
What is your father's name?	Tuma bapankara nama kana
what is your mother's name?	tuma ma kara naa kana
What is your name ?	Tumoro naamo kana ?
What is your name?	Tama na kn?
What is your name?	Tama naa kana?
What is your name?	Tama naa kana??
What is your name?	Tamar naa kana?
What is your name?	Tamara nama kana?
What is your name?	Tamo naa kono?
What is your name?	Tumara nama kana?
What is your name? 	Tumara naama kanna? 
What is your occupation?	Tume kn kara?
what time is breakfast/ supper?	jalakhia/ratri bhojan pain samaya kana?
What time is it ?	Kete samay hoichchi ?
what we really mean is that they're bad at not paying attention.	Aame bastabre jaha kahibaku chahuchu semane dhyana na debare kharap
what will you do	kan karibu
what will you say to me	tu kana kahibu mate
"whatever,we had to go by tommorow morning"	emiti bhi sakhale bhariba padiba
What'll happen?	Kana hebo?
What'll happen?	Kana hebo?
What's going on?	Kana chalichi
What's going on?ˆ	Kana chalichi
what's my fault	moro kan bhul
What's on TV?	T.V. re kana achhi ?
What's on TV?	T.V. re kana achhi ?
What's up	Kan chalichi kuha
what's up?        	kn krucha
What's wrong?	Kana bhul hela ?
What?«÷s your name?	Tora na kn?
When did he go?	Se kebe gale?
when did you sleep at night	tu ketebele soilu ratire
When the college will open ? 	Mahavidyalaya kebe kholiba ? 
"when the space race was going on,"	Jebebele space race chalithila
When will college open?	College kebe kholiba?
When will NIT Rourkela open?	NIT Rourkela kebe kholibo?
When will the college reopen ?	College kebe kholiba ?
when will you get to know	tu kebe janibu
Wher are you now ? 	Bartoman aapano keuthi aachii?? 
where	kuade
Where are we?	Ame keunthare achhu ?
Where are we?	Ame keunthare achhu ?
Where are you from ?	Apana keuntharu asichanti ?
Where are you from ?	Tume keu thara ?
Where are you going ?	Tame kuade jaucha ?
Where are you going?	Tume kuade jaucho?
Where are you going? 	Tome kuade jaucho
Where are you?	Apana keunthare achhanti?
Where are you?	Kouthi ki jauchu?
Where are you?	Tame kauthi acha?
Where are you?	Tame kauthi acha?
Where do you live?	Tame keunthi rahucha?
Where do you stay?	Tume kouthi ruha?
Where do you study?	Tame keunthi padhucha?
Where does this bus go?	Ei  bus kouthi ki jaye ?
where does this train/bus go?	ye train/bus kouthiki jaye?
Where have you been these days?	Aaji kalu kuade achu tu?
Where is Mary?	Mary keunthare?
where is my bag ?	Mo bag kouthi achhi ?
Where is Paris?	Paris kaunthare?
Where is Paris?	Paris kauthare?
Where is she?	Se keunthare achhi ?
Where is the toilet?	souchalaya kauthi?
Where is Tom?	Tom keunthare achhi ?
Where were you?	Tume kauthare thila?
Where were you?	Tume kauthare thila?
"where, the time, the website."	Keuthare kou samaya re website
Where's an ATM?	Atm kauthare achi?
Where's Boston?	Boston kauthare?
Where's Daddy?	Bapa keunthare 
Where's my bag?	Mora bag kauthare achi?
Where's my car?	Mora car kauthare achi?
Where's my cup?	Mora cup kauthare achi?
Where's my hat?	Mora topi kauthare achi
Where's my mom?	Mo maa kauthare?
Where's my son?	Mo pua kauthare?
Where's my stick?	badi kuade gala moro?
Where's my tip?	Mora tipanni kauthare achi?
Where's my tip?	Mora tipanni kauthare achi?
Which is mine?	Keunti mora?
white	dhala
Who are they?	Semane kie?
Who are you	Tume kie
Who are you?	Tume kie?
Who asked you?	Kie tumaku pacharila?
who ate. 	Kiye khaila
who ate. 	Kiye khaila
Who broke this?	Kiye ehaku bhangila
Who built it?	Kie ehaku nirmana karichhi?
Who built it?	Kie ehaku nirmana karichhi?
who cares?       	kie chinta kre
Who complained?	Kia abhijhoga kala
Who did he see?	Se kahaku dekhile?
Who did this?	Eha kie kala ?
Who did what?	Kie kana kala ?
Who disagreed?	Kie ethire sahamata nuhanti
Who found her?	Tanku kie paila?
Who found him?	Tanku kie paila?
Who found them?	Semananku kiye paila?
Who found this?	Ehaku kiye paila?
Who found Tom?	Tom ku kie paila?
Who found you?	Tumaku kie paila?
Who found you?	Tumaku kie paila?
Who found you?	Tumaku kie paila?
Who goes there?	Kiye sethaku jaye?
Who goes there?	Kiye sethaku jaye?
Who has it now?	Bartama kiye achi?
Who has it now?	Bartama kiye achi?
Who has it now?	Bartaman kiye achi?
Who helped Tom?	Tom ku kiye sahajya kala?
Who helps her?	Tanku kie sahajya kare?
Who hired you?	Tumaku kie nijukti dela?
Who hired you?	Tumaku kie nijukti dela?
Who intervened?	Kiye hastakhyapa kala?
Who intervened?	Kiye hastakhyapa kala?
Who is absent?	Kie anupasthita?
who is he?        	Sie kie
Who killed Tom?	Tom ku kiye hatya kala?
Who killed Tom?	Tom ku kiye hatya kala?
Who listened?	Kie sunila ?
Who listened?	Kie sunila ?
Who panicked?	Kie bhayabhita hela ?
Who panicked?	Kie bhayabhita hela ?
who ran.	 Kiye daudila
who ran. 	Kiye daudila
Who remembers?	Kie mane rakhichi?
Who removed it?	Kiye ehaku hataila?
Who removed it?	Kiye ehaku hataila?
Who removed it?	Kiye ehaku hataila?
Who said that?	Kie eha kahila?
Who says that?	kie eha kahuchi?
Who sells this?	Ehaku kiye bikri kare?
who spkoe?       	kie khila
who spoke?       	kie khila
Who succeeded?	kie safala hela?
Who survived?	Kie banchigala ?
Who survived?	Kie banchigala ?
Who told Tom?	Tom ku kie kahila ?
Who vanished?	Kie adrusya hela ?
Who vanished?	Kie adrusya hela ?
Who wants it?	Kie eha chaunchhi ?
Who wants tea?	cha chahanti kiye ?
Who was here?	Ethare kie thile ?
Who was right?	kiye thik thila ? 
who who	kie kie
Who will do it?	Kiye eha kariba?
Who will pay?	Kie debe ?
Who wrote this?	Kiye eha lekhichanti?
Who'd buy this?	Kiye ehaku kinibe?
Who'll drive?	Kie gadi chalaiba ?
Who'll fight?	Kie judhha kariba ?
who'll go?        	Kie jiba
Who'll start?	Kie arambha kariba?
Who'll start?	Kie arambha kariba?
Who'll succeed?	Kiye saphala hebo?
Who's at fault?	Doshi kiye?
Who's coming?	Kie asuchhi ?
Who's dieting?	kiye dieting karuchi ? 
Who's fasting?	kiye upabasa karuchanti ? 
Who's fasting?	kiye upabasa karuchanti ? 
Who's humming?	kiye hum karuchanti ? 
Who's joking?	Kie thatta karuchhi ?
Who's joking?	Kie thatta karuchhi ?
Who's missing?	kiye nikhoj ? 
Who's not busy?	Kiye byasta nuhanti?
Who's not busy?	Kiye byasta nuhanti?
Who's on watch?	Kiye jagrata achi?
Who's paying?	Kie deya deuchhi ?
Who's quitting?	Kiye chaduchi?
who's she?        	Sue kie
Who's standing?	Kiye thia hoichi?
Who's staying?	kiye rahe ? 
Who's talking?	kiye kahuchi ? 
Who's that boy?	Se balako kia?
Who's that for?	Taha pain kiye?
Who's thirsty?	kiye trusharta ? 
Who's watching?	Kiye dekhuchi?
Who's winning?	kiye jituchi ? 
Who's winning?	kiye jituchi ? 
Whose is this?	eha kahara ? 
Whose?	Kahara?
Why am I here?	mun ethare kainhinki acchi ? 
Why are you like this	Tu emiti kana pain achu
Why are you waiting?	Tame apekhya kahinki karucha ?
Why can't I go?	Mu kainki jaiparibi nahi?
Why do you ask?	Tame kahinki pacharucha?
Why do you lie?	Tume kahinki micha kahucha?
Why God give this much pain?	Bhagban mate ete dukha kai pai deichha? 
Why is college not opening? 	College kahinki kholuni? 
Why is he here?	Se ethare kahinki achanti?
Why is it dark?	Andhara kahinki?
Why is it here?	Eha ethare kahinki achi?
Why is it here?	Eha ethare kahinki achi?
Why is it here?	Eha ethare kahinki achi?
Why is Tom wet?	Tom odda kahinki?
why me	mu kahiki
Why quit now?	Bartaman kahinki chhadibe ?
wil come	asijibi
will buy silver	rupa kiniba
will come	aseba
Will I get party everyday ?	Mate sabu Dina bhoji miliba ki ?
will open	kholiba
Will she come?	se asiba ki ? 
Will you do it?	Apana eha karibe ki?
will you drink hot water	garam paani peeba
win	jetiba
Wind is flowing. 	Pabana chaluchi
Wish me luck.	Mon paen soubhaya kamana karantu.
women	mahila
Women hate me.	Mahila mane mate ghruna karanti .
wonderful!        	Bohut badhiya
wont happen	habani
woodcutter	kathuria
would you like to dance with me?	apana mo sangere nacibe ki?
Wow!	Bah!
Wow!	Bah!
write	lekhe
Write it down.	eha ku lekha .
writing paper	lekhakagaja
y cant you wake up early here	aithi kana nida bhanguni
Yeah its me over here	Mu aithi achi re
year	barsa
year	barsah
Years passed.	Barsa gala.
yellow	haladia
yellow	haldia
Yes	Han
"yes, a little"	"ha, tike tike"
"Yes, of course."	Han bikul!
"Yes, we can go."	"Han, ame jaipariba!"
yesterday	gata kali
you	tume
You all right?	tume sabu thik ? 
You all right?	tume sabu thik? 
you are a donkey	gadhoo ta tu
You are a fool	Tu gote boka 
You are a nice boy	Tume gote bhala pila
you are cheating me	tuma mate dhoka daucha
You are crazy.	tume pagala .
You are drunk!	tume madyapa !
You are drunk!	Tume madyapa !
You are drunk!	Tume madyapa !
You are good.	Tume bhala.
You are late.	Tume deri kala.
You are looking very beautiful today	Tume aaji bahut Sundar dekhajaucha
You are lying.	Tume micha kahucha .
You are morons.	Tume morons
You are morons.	Tume morons
You are rich.	Tume dhani.
You are rich.	Tume dhani.
You are stupid.	Tume gote murkha
You are ugly.	Tume asundar.
You are wrong.	Tume bhul .
You are wrong.	Tume bhul .
You are wrong.	Tume bhul .
You better go.	Tume bhala re jaya .
You better go.	Tume bhala re jaya .
You can come.	Apana asiparibe.
You can come.	Apana asiparibe.
You can do it.	Tume eha karipariba .
You can do it.	Tume eha karipqriba .
You can go now.	Apana bartaman jaiparibe!
You can rest.	Apana bishrama kariparibe.
You can rest.	Apana bishrama kariparibe.
You can rest.	Apana bishrama kariparibe.
You can rest.	Apana bishrama kariparibe.
You can rest.	Apana bishrama kariparibe.
You can rest.	Apana bishrama kariparibe.
You can't go.	Apana jaiparibe nahi.
You can't go.	Apana jaiparibe nahi.
You can't go.	Apana jaiparibe nahi.
You can't lose.	Tume harai pariba nahi!
You can't lose.	Tume harai pariba nahi!
You can't swim.	Tume harai pariba nahi!
You can't win.	Tume jitiba nahi .
You could lead.	Apana netruta neiparanti
You could lead.	Apana netruta neiparanti
You could lead.	Apana netruta neiparanti
You disgust me.	Tume mate ghrunna kara
You disgust me.	Tume mate ghrunna kara
you drive          	tume chlao
You fine?	Thik acha?
You flatter me.	Tume mate santusta kara
You go first.	Tume prathame jao.
You have mail.	Tumara mail acchi .
You have mail.	Tumara mail acchi .
You have to go.	Tumaku jibaku padiba
You hurt him.	Tume tanku aghata kala.
you idiot.          	tume idiot
You killed Tom.	Tume tamaku hatya kala
You killed Tom.	Tume tamaku hatya kala
You know her.	Tume tanku janichha.
You know how.	Apana jananti kipari.
You lied to me.	Tume mate micha kahicha
You lied to me.	Tume mate micha kahicha
You look busy.	Tume byasta dekhajaucha .
You look busy.	Tume byasta dekhajaucha .
You look busy.	Tume byasta dekhajaucha .
You look fat.	Tume mota dekhajauchha.
You look good.	Tume bhala dishucha .
You look good.	Tume bhala disucha .
You look great.	Tume bhala dekha jaucha
You look great.	Tume bhala dekha jaycha
You look pale.	Tume fika dekhajaucha.
You look sick.	Tume asustha dekhajaucha .
You look sick.	Tume asustha dekhajaucha .
You look tired.	Tume clanta dekha jaucha
You look upset.	Tume birakta dekha jaucha
You may enter.	Apana prabesha kariparibe .
You may enter.	Apana prabesha kariparibe .
You may enter.	Apana prabesha kariparibe .
You may go now.	Apana bartana jaiparanti
You may go now.	Apana bartana jaiparanti
You must do it.	Apana eha kariba zaruri
You must work.	Tume nischaya kama kariba .
You must work.	Tume nischaya kama kariba.
You need a key.	Tumara eka chabbi darkar
You need a key.	Tumara eka chabbi darkar
You need a key.	Tumara eka chabbi darkar
You need help.	Tumara sahajya darkar .
You need this.	Apana eha abashyaka karanti .
You need to go.	Tume jibaku padiba
You need to go.	Tume jibaku padiba
You need to go.	Tume jibaku padiba
You never know.	Apana kadapi jani nahanti
You people are doing a great job	Apone mane bhodia kaam karu chonti
You promised.	Tume pratigyan karichha.
You promised.	Tume pratigyan karichha.
You ruined it.	Tume eha ku nasta karicha .
you run. 	Tome dauda
you run. 	Tome dauda
You scare me.	Tume mate bhayabhita kara.
You scare me.	Tume mate bhayabhita kara.
You scare me.	Tume mate bhayabhita kara.
You seem busy.	Tume byasta thiba pari lagucha .
You seem busy.	Tume byasta thiba pari lagucha .
You seem busy.	Tume byasta thiba pari lagucha .
You seem upset.	Apana bibrata mane hauchanti
You seem upset.	Apana bibrata mane hauchanti
You seem upset.	Apana bibrata mane hauchanti
You should eat.	Tume khaiba uchit
You should eat.	Tume khaiba uchit
You should go.	Tume jiba ucchit .
You should go.	Tume jiba ucchit .
You should go.	Tume jiba ucchit .
You should go.	Tume jiba ucchit .
You should go.	Tume jiba ucchit .
You should go.	Tume jiba ucchit .
You smell good.	Tume bhala gandha karucha
you start          	tume arambha kara
You stay put.	Tume rakha.
You survived.	Tume banchichha.
You survived.	Tume banchichha.
You survived.	Tume banchichha.
You talk fast.	Tume sighra kathabarta kara .
you tried          	tume Chesta krila
You were brave.	Tume sahashi thila
You were brave.	Tume sahashi thila
You were busy.	Tume byasta thila .
You were great.	Tume mahan thila
You were happy.	Tume khusi thila
You were lucky.	Tume bhagyaban
You will fail.	Tume bifala heba .
you woke up so early in the morning	sakhale sakhale uthi padicha
you won. 	Tome jeetila
you won. 	Tome jeetila
you wont understand	bujhiparibuni tu
You work hard.	Tume kathina parishrama kara .
You'll all die.	Tume samaste mariba
You'll go far.	Tume bahuta duraku jiba .
You'll like it.	Apana ehaku pasand karibe
You're a liar.	Tume jane mithyabadi .
You're a loser.	Tume haricha
You're amazing.	Apana ascharyajanaka
You're amazing.	Apana ascharyajanaka
You're biased.	Tume pakhyapatita.
You're biased.	Tume pakhyapatita.
You're drunk.	Tume madyapana karichha.
You're drunk.	Tume madyapana karichha.
You're dying.	Tume maruchha.
You're dying.	Tume maruchha.
You're dying.	Tume maruchha.
You're dying.	Tume maruchha.
You're famous.	Tume prasidha .
You're famous.	Tume prasidha .
You're fired.	Tume barakhaasta.
You're fired.	Tume barakhaasta.
You're fired.	Tume barakhaasta.
You're funny.	Tume majaliya.
You're gross.	Tume majaliya.
You're humming.	Tume hamma karucha
You're humming.	Tume hamma karucha
You're humming.	Tume hamma karucha
You're humming.	Tume hamma karucha
You're humming.	Tume hamma karucha
You're humming.	Tume hamma karucha
You're in love.	Tume prema re acha
You're in luck.	Apana bhagya re achanti
You're insane.	Tume pagala.
You're insane.	Tume pagala.
You're invited.	Tume nimantrita
You're invited.	Tume nimantrita
You're invited.	Tume nimantrita
You're jealous.	Tume ersha re jalucha
You're joking!	Tume thatta karucha !
You're joking!	Tume thatta karucha !
You're joking!	Tume thatta karucha !
You're joking!	Tume thatta karucha !
You're joking!	Tume thatta karucha !
You're joking!	Tume thatta karucha ! 
You're kidding!	Tume maja karucha
You're kidding!	Tume maja karucha
You're kidding!	Tume maja karucha
You're kidding!	Tume maja karucha
You're kidding!	Tume maja karucha
You're kidding!	Tume maja karucha
You're kidding!	Tume maja karucha
You're lying!	Tume michha kahuchha.
You're lying!	Tume michha kahuchha.
You're lying.	Tume michha kahuchha.
You're moody.	Tume manobola.
You're my boss.	Tume mora bash
You're my boss.	Tume mora bash
You're my hero.	Tume mora hero
You're my son.	Tume mora pua .
You're my type.	Tume mora prakara
You're nervous.	Tume  nervous
You're nervous.	Tume nervous
You're nervous.	Tume nervous
You're not fit.	Apana fit nuhanti
You're not fit.	Apana fit nuhanti
You're not God.	Tume bhagban nuhe
You're paying.	Tume deya daucha ! 
You're paying.	Tume deya daucha .
You're quiet.	Tume shaanta.
You're right.	Tume theek.
You're selfish.	Tume swarthapara
You're silly.	Tume murkha.
You're silly.	Tume murkha.
You're silly.	Tume murkha.
You're so lazy.	Tume bahut alashua
You're so lazy.	Tume bahut alashua
You're so lazy.	Tume bahut alashua
You're so lazy.	Tume bahut alashua
You're sweet.	Tume meetha.
You're the man.	Tume sehi byakti
You're unlucky.	Apana bhyagashali atanti
You're unlucky.	Apana bhyagashali atanti
You're unlucky.	Apana bhyagashali atanti
You're unusual.	Apana asadharana atanti
You're unusual.	Apana asadharana atanti
You're unusual.	Apana asadharana atanti
You're upset.	Tume birakta.
You're upset.	Tume birakta.
You're upset.	Tume birakta.
You're upset.	Tume birakta.
You're upset.	Tume birakta.
You're useless.	Tume adarakari
You're useless.	Tume adarakari
You're useless.	Tume adarakari
You're useless.	Tume adarakari
You're useless.	Tume adarakari
You're useless.	Tume dhani
You're vague.	Tume aspasta.
You're wealthy.	Tume dhani
You're wealthy.	Tume dhani
You're wealthy.	Tume dhani
You're welcome.	Apana swagata
You're welcome.	Apana swagata
You're winning.	Tume jitucha
You're winning.	Tume jitucha
You're winning.	Tume jitucha
You're winning.	Tume jitucha
You're winning.	Tume jitucha
You're winning.	Tume jitucha
You're witty.	Tume chatura.
You're witty.	Tume chatura.
You're witty.	Tume chatura.
You're worried.	Tume chintita
You're worried.	Tume chintita
You're worried.	Tume chintita
You're worried.	Tume chintita
You're worried.	Tume chintita
You're worried.	Tume chintita
You're wounded.	Tume aahata
You're wounded.	Tume aahata
You're wounded.	Tume aahata
You're young.	Tume jubaka.
You're young.	Tume jubaka.
You've changed.	Apana paribartan karuchanti
You've done it!	Tume eha karicha!
You've done it!	Tume eha karicha!
You've done it!	Tume eha karicha!
